"Season_End_Year","Squad","Comp","Team_or_Opponent","Num_Players","Mins_Per_90","Tkl_Tackles","TklW_Tackles","Def 3rd_Tackles","Mid 3rd_Tackles","Att 3rd_Tackles","Tkl_Challenges","Att_Challenges","Tkl_percent_Challenges","Lost_Challenges","Blocks_Blocks","Sh_Blocks","Pass_Blocks","Int","Tkl+Int","Clr","Err","Url"
2018,"Alavés","La Liga","team",30,38,702,464,364,265,73,267,663,40.3,396,407,133,274,498,1200,981,11,"https://fbref.com/en/squads/8d6fd021/2017-2018/Alaves-Stats"
2018,"Alavés","La Liga","opponent",30,38,650,462,323,246,81,246,576,42.7,330,317,88,229,422,1072,721,5,"https://fbref.com/en/squads/8d6fd021/2017-2018/Alaves-Stats"
2018,"Amiens","Ligue 1","team",30,38,658,445,336,252,70,243,623,39,380,444,164,280,523,1181,1128,20,"https://fbref.com/en/squads/25622401/2017-2018/Amiens-Stats"
2018,"Amiens","Ligue 1","opponent",30,38,716,457,304,334,78,213,610,34.9,397,365,86,279,470,1186,794,11,"https://fbref.com/en/squads/25622401/2017-2018/Amiens-Stats"
2018,"Angers","Ligue 1","team",27,38,661,427,350,240,71,244,766,31.9,522,402,79,323,410,1071,853,14,"https://fbref.com/en/squads/69236f98/2017-2018/Angers-Stats"
2018,"Angers","Ligue 1","opponent",27,38,718,469,360,300,58,227,606,37.5,379,421,113,308,436,1154,902,9,"https://fbref.com/en/squads/69236f98/2017-2018/Angers-Stats"
2018,"Arsenal","Premier League","team",30,38,623,425,312,227,84,218,581,37.5,363,372,103,269,427,1050,879,33,"https://fbref.com/en/squads/18bb7c10/2017-2018/Arsenal-Stats"
2018,"Arsenal","Premier League","opponent",30,38,576,347,293,216,67,164,547,30,383,508,164,344,584,1160,1079,15,"https://fbref.com/en/squads/18bb7c10/2017-2018/Arsenal-Stats"
2018,"Atalanta","Serie A","team",25,38,725,488,334,313,78,272,650,41.8,378,430,107,323,476,1201,820,11,"https://fbref.com/en/squads/922493f3/2017-2018/Atalanta-Stats"
2018,"Atalanta","Serie A","opponent",25,38,711,484,375,272,64,262,704,37.2,442,505,157,348,589,1300,935,20,"https://fbref.com/en/squads/922493f3/2017-2018/Atalanta-Stats"
2018,"Athletic Club","La Liga","team",26,38,739,486,359,304,76,296,735,40.3,439,432,103,329,465,1204,820,9,"https://fbref.com/en/squads/2b390eca/2017-2018/Athletic-Club-Stats"
2018,"Athletic Club","La Liga","opponent",26,38,670,449,332,280,58,261,611,42.7,350,374,76,298,422,1092,919,6,"https://fbref.com/en/squads/2b390eca/2017-2018/Athletic-Club-Stats"
2018,"Atlético Madrid","La Liga","team",26,38,917,614,442,372,103,377,847,44.5,470,462,129,333,513,1430,885,4,"https://fbref.com/en/squads/db3b9613/2017-2018/Atletico-Madrid-Stats"
2018,"Atlético Madrid","La Liga","opponent",26,38,715,494,346,273,96,267,693,38.5,426,390,91,299,488,1203,792,12,"https://fbref.com/en/squads/db3b9613/2017-2018/Atletico-Madrid-Stats"
2018,"Augsburg","Bundesliga","team",27,34,723,543,361,292,70,364,603,60.4,239,400,107,293,400,1123,835,15,"https://fbref.com/en/squads/0cdc4311/2017-2018/Augsburg-Stats"
2018,"Augsburg","Bundesliga","opponent",27,34,576,427,282,242,52,256,441,58,185,400,93,307,342,918,844,14,"https://fbref.com/en/squads/0cdc4311/2017-2018/Augsburg-Stats"
2018,"Barcelona","La Liga","team",25,38,629,413,281,262,86,229,552,41.5,323,366,103,263,424,1053,525,10,"https://fbref.com/en/squads/206d90db/2017-2018/Barcelona-Stats"
2018,"Barcelona","La Liga","opponent",25,38,819,517,438,307,74,354,973,36.4,619,477,128,349,618,1437,694,14,"https://fbref.com/en/squads/206d90db/2017-2018/Barcelona-Stats"
2018,"Bayern Munich","Bundesliga","team",28,34,609,467,269,248,92,308,549,56.1,241,313,75,238,355,964,399,11,"https://fbref.com/en/squads/054efa67/2017-2018/Bayern-Munich-Stats"
2018,"Bayern Munich","Bundesliga","opponent",28,34,621,472,358,213,50,402,679,59.2,277,425,123,302,411,1032,922,14,"https://fbref.com/en/squads/054efa67/2017-2018/Bayern-Munich-Stats"
2018,"Benevento","Serie A","team",41,38,581,409,320,206,55,191,551,34.7,360,398,140,258,449,1030,925,25,"https://fbref.com/en/squads/4fcb34fd/2017-2018/Benevento-Stats"
2018,"Benevento","Serie A","opponent",41,38,697,450,313,269,115,272,665,40.9,393,398,104,294,430,1127,742,11,"https://fbref.com/en/squads/4fcb34fd/2017-2018/Benevento-Stats"
2018,"Betis","La Liga","team",29,38,635,424,319,252,64,213,537,39.7,324,356,95,261,427,1062,869,17,"https://fbref.com/en/squads/fc536746/2017-2018/Real-Betis-Stats"
2018,"Betis","La Liga","opponent",29,38,622,405,296,261,65,240,679,35.3,439,356,94,262,448,1070,566,8,"https://fbref.com/en/squads/fc536746/2017-2018/Real-Betis-Stats"
2018,"Bologna","Serie A","team",30,38,661,456,356,257,48,231,588,39.3,357,488,127,361,462,1123,1121,14,"https://fbref.com/en/squads/1d8099f8/2017-2018/Bologna-Stats"
2018,"Bologna","Serie A","opponent",30,38,616,417,260,265,91,143,470,30.4,327,423,97,326,464,1080,830,16,"https://fbref.com/en/squads/1d8099f8/2017-2018/Bologna-Stats"
2018,"Bordeaux","Ligue 1","team",31,38,699,459,311,322,66,246,682,36.1,436,355,110,245,464,1163,855,13,"https://fbref.com/en/squads/123f3efe/2017-2018/Bordeaux-Stats"
2018,"Bordeaux","Ligue 1","opponent",31,38,732,451,342,299,91,306,765,40,459,389,104,285,468,1200,893,13,"https://fbref.com/en/squads/123f3efe/2017-2018/Bordeaux-Stats"
2018,"Bournemouth","Premier League","team",22,38,509,324,272,187,50,198,525,37.7,327,453,160,293,367,876,1129,25,"https://fbref.com/en/squads/4ba7cbea/2017-2018/Bournemouth-Stats"
2018,"Bournemouth","Premier League","opponent",22,38,714,500,316,316,82,293,636,46.1,343,441,129,312,555,1269,980,13,"https://fbref.com/en/squads/4ba7cbea/2017-2018/Bournemouth-Stats"
2018,"Brighton","Premier League","team",24,38,599,380,360,205,34,205,642,31.9,437,430,190,240,449,1048,1182,18,"https://fbref.com/en/squads/d07537b9/2017-2018/Brighton-and-Hove-Albion-Stats"
2018,"Brighton","Premier League","opponent",24,38,483,327,239,182,62,188,487,38.6,299,351,96,255,385,868,854,14,"https://fbref.com/en/squads/d07537b9/2017-2018/Brighton-and-Hove-Albion-Stats"
2018,"Burnley","Premier League","team",24,38,533,355,272,217,44,204,553,36.9,349,457,191,266,400,933,1300,8,"https://fbref.com/en/squads/943e8050/2017-2018/Burnley-Stats"
2018,"Burnley","Premier League","opponent",24,38,472,332,244,185,43,127,345,36.8,218,318,92,226,339,811,1134,14,"https://fbref.com/en/squads/943e8050/2017-2018/Burnley-Stats"
2018,"Caen","Ligue 1","team",26,38,733,478,369,295,69,276,747,36.9,471,450,97,353,476,1209,961,12,"https://fbref.com/en/squads/74229020/2017-2018/Caen-Stats"
2018,"Caen","Ligue 1","opponent",26,38,626,412,289,276,61,163,469,34.8,306,356,105,251,468,1094,1142,15,"https://fbref.com/en/squads/74229020/2017-2018/Caen-Stats"
2018,"Cagliari","Serie A","team",29,38,640,447,323,239,78,214,559,38.3,345,425,126,299,431,1071,1018,4,"https://fbref.com/en/squads/c4260e09/2017-2018/Cagliari-Stats"
2018,"Cagliari","Serie A","opponent",29,38,521,357,233,228,60,171,409,41.8,238,372,97,275,401,922,1056,16,"https://fbref.com/en/squads/c4260e09/2017-2018/Cagliari-Stats"
2018,"Celta Vigo","La Liga","team",23,38,589,420,304,232,53,218,556,39.2,338,327,101,226,497,1086,780,10,"https://fbref.com/en/squads/f25da7fb/2017-2018/Celta-Vigo-Stats"
2018,"Celta Vigo","La Liga","opponent",23,38,655,426,296,288,71,227,603,37.6,376,372,103,269,495,1150,735,13,"https://fbref.com/en/squads/f25da7fb/2017-2018/Celta-Vigo-Stats"
2018,"Chelsea","Premier League","team",26,38,636,426,321,251,64,208,550,37.8,342,365,107,258,424,1060,842,24,"https://fbref.com/en/squads/cff3d9bb/2017-2018/Chelsea-Stats"
2018,"Chelsea","Premier League","opponent",26,38,635,427,326,236,73,221,734,30.1,513,478,173,305,547,1182,1006,19,"https://fbref.com/en/squads/cff3d9bb/2017-2018/Chelsea-Stats"
2018,"Chievo","Serie A","team",25,38,543,367,273,199,71,208,566,36.7,358,443,158,285,444,987,1140,14,"https://fbref.com/en/squads/cc919b35/2017-2018/Chievo-Stats"
2018,"Chievo","Serie A","opponent",25,38,516,339,244,212,60,174,378,46,204,333,77,256,400,916,1011,11,"https://fbref.com/en/squads/cc919b35/2017-2018/Chievo-Stats"
2018,"Crotone","Serie A","team",29,38,697,440,365,255,77,222,613,36.2,391,449,119,330,578,1275,1233,10,"https://fbref.com/en/squads/3074d7b1/2017-2018/Crotone-Stats"
2018,"Crotone","Serie A","opponent",29,38,555,388,248,232,75,167,418,40,251,406,83,323,468,1023,871,15,"https://fbref.com/en/squads/3074d7b1/2017-2018/Crotone-Stats"
2018,"Crystal Palace","Premier League","team",28,38,686,447,393,237,56,260,666,39,406,466,117,349,552,1238,1110,22,"https://fbref.com/en/squads/47c64c55/2017-2018/Crystal-Palace-Stats"
2018,"Crystal Palace","Premier League","opponent",28,38,721,447,332,288,101,239,718,33.3,479,404,137,267,409,1130,1034,25,"https://fbref.com/en/squads/47c64c55/2017-2018/Crystal-Palace-Stats"
2018,"Dijon","Ligue 1","team",26,38,685,462,363,264,58,250,687,36.4,437,385,118,267,544,1229,977,20,"https://fbref.com/en/squads/8dfb7350/2017-2018/Dijon-Stats"
2018,"Dijon","Ligue 1","opponent",26,38,627,414,280,268,79,183,624,29.3,441,361,95,266,403,1030,902,13,"https://fbref.com/en/squads/8dfb7350/2017-2018/Dijon-Stats"
2018,"Dortmund","Bundesliga","team",30,34,695,510,305,307,83,346,602,57.5,256,390,73,317,336,1031,657,17,"https://fbref.com/en/squads/add600ae/2017-2018/Dortmund-Stats"
2018,"Dortmund","Bundesliga","opponent",30,34,696,513,355,290,51,375,679,55.2,304,422,122,300,446,1142,843,18,"https://fbref.com/en/squads/add600ae/2017-2018/Dortmund-Stats"
2018,"Eibar","La Liga","team",27,38,643,436,271,282,90,258,613,42.1,355,349,53,296,554,1197,712,9,"https://fbref.com/en/squads/bea5c710/2017-2018/Eibar-Stats"
2018,"Eibar","La Liga","opponent",27,38,671,435,402,231,38,297,649,45.8,352,401,115,286,510,1181,1156,4,"https://fbref.com/en/squads/bea5c710/2017-2018/Eibar-Stats"
2018,"Eint Frankfurt","Bundesliga","team",28,34,623,483,271,295,57,289,541,53.4,252,465,101,364,409,1032,918,8,"https://fbref.com/en/squads/f0ac8ee6/2017-2018/Eintracht-Frankfurt-Stats"
2018,"Eint Frankfurt","Bundesliga","opponent",28,34,658,477,356,245,57,304,550,55.3,246,454,83,371,369,1027,749,23,"https://fbref.com/en/squads/f0ac8ee6/2017-2018/Eintracht-Frankfurt-Stats"
2018,"Espanyol","La Liga","team",25,38,716,500,357,278,81,271,700,38.7,429,362,116,246,515,1231,902,9,"https://fbref.com/en/squads/a8661628/2017-2018/Espanyol-Stats"
2018,"Espanyol","La Liga","opponent",25,38,661,443,318,275,68,273,596,45.8,323,404,95,309,433,1094,846,9,"https://fbref.com/en/squads/a8661628/2017-2018/Espanyol-Stats"
2018,"Everton","Premier League","team",30,38,644,447,360,206,78,223,612,36.4,389,426,160,266,514,1158,1308,22,"https://fbref.com/en/squads/d3fd31cc/2017-2018/Everton-Stats"
2018,"Everton","Premier League","opponent",30,38,578,374,279,232,67,197,461,42.7,264,417,88,329,408,986,929,19,"https://fbref.com/en/squads/d3fd31cc/2017-2018/Everton-Stats"
2018,"Fiorentina","Serie A","team",27,38,742,497,362,284,96,267,656,40.7,389,438,75,363,489,1231,983,17,"https://fbref.com/en/squads/421387cf/2017-2018/Fiorentina-Stats"
2018,"Fiorentina","Serie A","opponent",27,38,627,448,331,242,54,220,568,38.7,348,398,138,260,423,1050,1018,17,"https://fbref.com/en/squads/421387cf/2017-2018/Fiorentina-Stats"
2018,"Freiburg","Bundesliga","team",29,34,639,465,300,289,50,284,551,51.5,267,421,117,304,392,1031,802,6,"https://fbref.com/en/squads/a486e511/2017-2018/Freiburg-Stats"
2018,"Freiburg","Bundesliga","opponent",29,34,627,473,258,291,78,235,454,51.8,219,449,96,353,359,986,650,11,"https://fbref.com/en/squads/a486e511/2017-2018/Freiburg-Stats"
2018,"Genoa","Serie A","team",33,38,551,395,281,223,47,191,524,36.5,333,412,119,293,394,945,950,11,"https://fbref.com/en/squads/658bf2de/2017-2018/Genoa-Stats"
2018,"Genoa","Serie A","opponent",33,38,559,388,283,221,55,176,507,34.7,331,400,102,298,394,953,1003,9,"https://fbref.com/en/squads/658bf2de/2017-2018/Genoa-Stats"
2018,"Getafe","La Liga","team",32,38,715,491,369,267,79,276,732,37.7,456,350,69,281,487,1202,899,5,"https://fbref.com/en/squads/7848bd64/2017-2018/Getafe-Stats"
2018,"Getafe","La Liga","opponent",32,38,696,480,350,273,73,288,584,49.3,296,357,83,274,515,1211,788,14,"https://fbref.com/en/squads/7848bd64/2017-2018/Getafe-Stats"
2018,"Girona","La Liga","team",25,38,611,403,299,254,58,240,606,39.6,366,329,84,245,490,1101,858,6,"https://fbref.com/en/squads/9024a00a/2017-2018/Girona-Stats"
2018,"Girona","La Liga","opponent",25,38,653,439,318,268,67,284,644,44.1,360,308,96,212,396,1049,896,16,"https://fbref.com/en/squads/9024a00a/2017-2018/Girona-Stats"
2018,"Guingamp","Ligue 1","team",23,38,640,437,310,271,59,228,672,33.9,444,368,121,247,475,1115,976,15,"https://fbref.com/en/squads/d41b5f53/2017-2018/Guingamp-Stats"
2018,"Guingamp","Ligue 1","opponent",23,38,659,455,330,264,65,218,618,35.3,400,346,80,266,481,1140,894,19,"https://fbref.com/en/squads/d41b5f53/2017-2018/Guingamp-Stats"
2018,"Hamburger SV","Bundesliga","team",29,34,729,543,346,313,70,331,641,51.6,310,496,112,384,367,1096,768,16,"https://fbref.com/en/squads/26790c6a/2017-2018/Hamburger-SV-Stats"
2018,"Hamburger SV","Bundesliga","opponent",29,34,771,552,385,308,78,406,671,60.5,265,473,99,374,385,1156,937,13,"https://fbref.com/en/squads/26790c6a/2017-2018/Hamburger-SV-Stats"
2018,"Hannover 96","Bundesliga","team",26,34,668,490,346,269,53,353,661,53.4,308,474,134,340,382,1050,962,19,"https://fbref.com/en/squads/60b5e41f/2017-2018/Hannover-96-Stats"
2018,"Hannover 96","Bundesliga","opponent",26,34,641,491,277,284,80,254,484,52.5,230,462,97,365,378,1019,777,9,"https://fbref.com/en/squads/60b5e41f/2017-2018/Hannover-96-Stats"
2018,"Hellas Verona","Serie A","team",32,38,664,459,351,245,68,213,603,35.3,390,425,146,279,541,1205,1113,24,"https://fbref.com/en/squads/0e72edf2/2017-2018/Hellas-Verona-Stats"
2018,"Hellas Verona","Serie A","opponent",32,38,630,442,283,277,70,214,584,36.6,370,368,96,272,404,1034,804,9,"https://fbref.com/en/squads/0e72edf2/2017-2018/Hellas-Verona-Stats"
2018,"Hertha BSC","Bundesliga","team",25,34,655,488,325,268,62,313,515,60.8,202,436,91,345,386,1041,876,13,"https://fbref.com/en/squads/2818f8bc/2017-2018/Hertha-BSC-Stats"
2018,"Hertha BSC","Bundesliga","opponent",25,34,619,460,288,278,53,313,553,56.6,240,390,66,324,391,1010,654,10,"https://fbref.com/en/squads/2818f8bc/2017-2018/Hertha-BSC-Stats"
2018,"Hoffenheim","Bundesliga","team",26,34,688,516,325,300,63,320,571,56,251,440,98,342,345,1033,648,15,"https://fbref.com/en/squads/033ea6b8/2017-2018/Hoffenheim-Stats"
2018,"Hoffenheim","Bundesliga","opponent",26,34,692,504,312,305,75,319,552,57.8,233,454,120,334,435,1127,755,15,"https://fbref.com/en/squads/033ea6b8/2017-2018/Hoffenheim-Stats"
2018,"Huddersfield","Premier League","team",25,38,743,502,354,306,83,249,630,39.5,381,453,118,335,518,1261,1129,22,"https://fbref.com/en/squads/f5922ca5/2017-2018/Huddersfield-Town-Stats"
2018,"Huddersfield","Premier League","opponent",25,38,631,433,316,272,43,215,491,43.8,276,408,106,302,440,1071,1081,15,"https://fbref.com/en/squads/f5922ca5/2017-2018/Huddersfield-Town-Stats"
2018,"Inter","Serie A","team",22,38,632,435,318,252,62,237,612,38.7,375,349,109,240,402,1034,804,11,"https://fbref.com/en/squads/d609edc0/2017-2018/Internazionale-Stats"
2018,"Inter","Serie A","opponent",22,38,553,389,253,222,78,194,550,35.3,356,380,112,268,466,1019,1173,15,"https://fbref.com/en/squads/d609edc0/2017-2018/Internazionale-Stats"
2018,"Juventus","Serie A","team",24,38,517,359,234,204,79,155,447,34.7,292,312,77,235,421,938,747,17,"https://fbref.com/en/squads/e0652b02/2017-2018/Juventus-Stats"
2018,"Juventus","Serie A","opponent",24,38,601,363,296,231,74,205,724,28.3,519,431,130,301,467,1068,843,11,"https://fbref.com/en/squads/e0652b02/2017-2018/Juventus-Stats"
2018,"Köln","Bundesliga","team",31,34,678,502,363,274,41,337,635,53.1,298,421,106,315,389,1067,832,17,"https://fbref.com/en/squads/bc357bf7/2017-2018/Koln-Stats"
2018,"Köln","Bundesliga","opponent",31,34,585,447,274,248,63,327,558,58.6,231,427,93,334,367,952,865,16,"https://fbref.com/en/squads/bc357bf7/2017-2018/Koln-Stats"
2018,"La Coruña","La Liga","team",32,38,728,500,386,282,60,292,679,43,387,391,113,278,484,1212,942,13,"https://fbref.com/en/squads/2a60ed82/2017-2018/Deportivo-La-Coruna-Stats"
2018,"La Coruña","La Liga","opponent",32,38,624,431,306,263,55,245,620,39.5,375,356,102,254,491,1115,825,8,"https://fbref.com/en/squads/2a60ed82/2017-2018/Deportivo-La-Coruna-Stats"
2018,"Las Palmas","La Liga","team",36,38,654,433,325,269,60,268,647,41.4,379,367,112,255,508,1162,713,21,"https://fbref.com/en/squads/0049d422/2017-2018/Las-Palmas-Stats"
2018,"Las Palmas","La Liga","opponent",36,38,722,514,306,331,85,264,713,37,449,355,90,265,506,1228,785,5,"https://fbref.com/en/squads/0049d422/2017-2018/Las-Palmas-Stats"
2018,"Lazio","Serie A","team",24,38,677,450,299,298,80,223,632,35.3,409,410,107,303,494,1171,789,12,"https://fbref.com/en/squads/7213da33/2017-2018/Lazio-Stats"
2018,"Lazio","Serie A","opponent",24,38,692,464,351,260,81,244,708,34.5,464,466,122,344,495,1187,952,15,"https://fbref.com/en/squads/7213da33/2017-2018/Lazio-Stats"
2018,"Leganés","La Liga","team",28,38,721,483,350,307,64,323,697,46.3,374,361,87,274,583,1304,777,9,"https://fbref.com/en/squads/7c6f2c78/2017-2018/Leganes-Stats"
2018,"Leganés","La Liga","opponent",28,38,720,474,356,284,80,267,608,43.9,341,371,85,286,432,1152,796,7,"https://fbref.com/en/squads/7c6f2c78/2017-2018/Leganes-Stats"
2018,"Leicester City","Premier League","team",27,38,630,417,332,249,49,208,616,33.8,408,465,130,335,414,1044,1007,17,"https://fbref.com/en/squads/a2d435b3/2017-2018/Leicester-City-Stats"
2018,"Leicester City","Premier League","opponent",27,38,653,437,326,253,74,294,716,41.1,422,374,115,259,402,1055,1084,18,"https://fbref.com/en/squads/a2d435b3/2017-2018/Leicester-City-Stats"
2018,"Levante","La Liga","team",33,38,616,414,328,222,66,239,625,38.2,386,395,127,268,477,1093,811,9,"https://fbref.com/en/squads/9800b6a1/2017-2018/Levante-Stats"
2018,"Levante","La Liga","opponent",33,38,755,522,380,282,93,310,685,45.3,375,380,105,275,454,1209,813,7,"https://fbref.com/en/squads/9800b6a1/2017-2018/Levante-Stats"
2018,"Leverkusen","Bundesliga","team",24,34,645,482,292,291,62,325,560,58,235,480,83,397,390,1035,621,9,"https://fbref.com/en/squads/c7a9f859/2017-2018/Bayer-Leverkusen-Stats"
2018,"Leverkusen","Bundesliga","opponent",24,34,708,491,322,307,79,325,633,51.3,308,524,130,394,427,1135,752,14,"https://fbref.com/en/squads/c7a9f859/2017-2018/Bayer-Leverkusen-Stats"
2018,"Lille","Ligue 1","team",25,38,681,453,364,261,56,229,606,37.8,377,378,108,270,492,1173,776,21,"https://fbref.com/en/squads/cb188c0c/2017-2018/Lille-Stats"
2018,"Lille","Ligue 1","opponent",25,38,799,516,363,344,92,247,823,30,576,402,101,301,489,1288,744,12,"https://fbref.com/en/squads/cb188c0c/2017-2018/Lille-Stats"
2018,"Liverpool","Premier League","team",27,38,637,450,265,285,87,196,521,37.6,325,388,71,317,379,1016,788,12,"https://fbref.com/en/squads/822bd0ba/2017-2018/Liverpool-Stats"
2018,"Liverpool","Premier League","opponent",27,38,658,435,373,240,45,210,649,32.4,439,465,174,291,506,1164,1111,39,"https://fbref.com/en/squads/822bd0ba/2017-2018/Liverpool-Stats"
2018,"Lyon","Ligue 1","team",26,38,639,411,283,285,71,207,573,36.1,366,352,101,251,450,1089,863,18,"https://fbref.com/en/squads/d53c0b06/2017-2018/Lyon-Stats"
2018,"Lyon","Ligue 1","opponent",26,38,804,504,430,302,72,305,865,35.3,560,433,136,297,462,1266,756,28,"https://fbref.com/en/squads/d53c0b06/2017-2018/Lyon-Stats"
2018,"M'Gladbach","Bundesliga","team",27,34,674,488,326,277,71,343,598,57.4,255,466,108,358,384,1058,719,17,"https://fbref.com/en/squads/32f3ee20/2017-2018/Monchengladbach-Stats"
2018,"M'Gladbach","Bundesliga","opponent",27,34,739,527,362,322,55,357,669,53.4,312,484,116,368,425,1164,664,13,"https://fbref.com/en/squads/32f3ee20/2017-2018/Monchengladbach-Stats"
2018,"Mainz 05","Bundesliga","team",27,34,699,522,339,277,83,353,625,56.5,272,502,107,395,402,1101,796,15,"https://fbref.com/en/squads/a224b06a/2017-2018/Mainz-05-Stats"
2018,"Mainz 05","Bundesliga","opponent",27,34,751,555,342,327,82,361,634,56.9,273,387,78,309,381,1132,712,19,"https://fbref.com/en/squads/a224b06a/2017-2018/Mainz-05-Stats"
2018,"Manchester City","Premier League","team",25,38,563,381,257,215,91,195,561,34.8,366,328,53,275,346,909,620,19,"https://fbref.com/en/squads/b8fd03ef/2017-2018/Manchester-City-Stats"
2018,"Manchester City","Premier League","opponent",25,38,635,416,418,169,48,229,732,31.3,503,473,152,321,599,1234,989,24,"https://fbref.com/en/squads/b8fd03ef/2017-2018/Manchester-City-Stats"
2018,"Manchester Utd","Premier League","team",27,38,564,369,275,218,71,173,555,31.2,382,382,112,270,481,1045,926,20,"https://fbref.com/en/squads/19538871/2017-2018/Manchester-United-Stats"
2018,"Manchester Utd","Premier League","opponent",27,38,669,447,388,218,63,270,736,36.7,466,456,165,291,438,1107,1068,15,"https://fbref.com/en/squads/19538871/2017-2018/Manchester-United-Stats"
2018,"Marseille","Ligue 1","team",26,38,757,505,331,340,86,291,755,38.5,464,392,102,290,448,1205,797,17,"https://fbref.com/en/squads/5725cc7b/2017-2018/Marseille-Stats"
2018,"Marseille","Ligue 1","opponent",26,38,713,447,387,261,65,252,786,32.1,534,411,162,249,473,1186,948,26,"https://fbref.com/en/squads/5725cc7b/2017-2018/Marseille-Stats"
2018,"Metz","Ligue 1","team",36,38,707,458,359,281,67,252,682,37,430,375,94,281,511,1218,848,12,"https://fbref.com/en/squads/f83960ae/2017-2018/Metz-Stats"
2018,"Metz","Ligue 1","opponent",36,38,580,416,292,234,54,267,623,42.9,356,396,98,298,433,1013,929,13,"https://fbref.com/en/squads/f83960ae/2017-2018/Metz-Stats"
2018,"Milan","Serie A","team",23,38,533,376,244,214,75,181,466,38.8,285,422,103,319,354,887,855,20,"https://fbref.com/en/squads/dc56fe14/2017-2018/Milan-Stats"
2018,"Milan","Serie A","opponent",23,38,541,346,264,225,52,152,450,33.8,298,437,143,294,432,973,1057,10,"https://fbref.com/en/squads/dc56fe14/2017-2018/Milan-Stats"
2018,"Monaco","Ligue 1","team",32,38,719,433,283,347,89,263,700,37.6,437,394,107,287,497,1216,1000,9,"https://fbref.com/en/squads/fd6114db/2017-2018/Monaco-Stats"
2018,"Monaco","Ligue 1","opponent",32,38,672,451,353,269,50,288,639,45.1,351,350,121,229,427,1099,929,28,"https://fbref.com/en/squads/fd6114db/2017-2018/Monaco-Stats"
2018,"Montpellier","Ligue 1","team",23,38,680,450,307,303,70,229,589,38.9,360,343,97,246,499,1179,879,16,"https://fbref.com/en/squads/281b0e73/2017-2018/Montpellier-Stats"
2018,"Montpellier","Ligue 1","opponent",23,38,633,430,343,238,52,241,623,38.7,382,367,107,260,501,1134,968,14,"https://fbref.com/en/squads/281b0e73/2017-2018/Montpellier-Stats"
2018,"Málaga","La Liga","team",37,38,745,509,383,276,86,272,707,38.5,435,362,101,261,497,1242,890,3,"https://fbref.com/en/squads/1c896955/2017-2018/Malaga-Stats"
2018,"Málaga","La Liga","opponent",37,38,748,509,347,315,86,278,586,47.4,308,359,88,271,452,1200,941,8,"https://fbref.com/en/squads/1c896955/2017-2018/Malaga-Stats"
2018,"Nantes","Ligue 1","team",30,38,756,510,383,302,71,272,662,41.1,390,495,138,357,426,1182,1052,14,"https://fbref.com/en/squads/d7a486cd/2017-2018/Nantes-Stats"
2018,"Nantes","Ligue 1","opponent",30,38,657,422,330,258,69,198,541,36.6,343,422,124,298,448,1105,926,13,"https://fbref.com/en/squads/d7a486cd/2017-2018/Nantes-Stats"
2018,"Napoli","Serie A","team",23,38,599,407,208,308,83,221,581,38,360,403,67,336,341,940,565,16,"https://fbref.com/en/squads/d48ad4ff/2017-2018/Napoli-Stats"
2018,"Napoli","Serie A","opponent",23,38,631,415,350,229,52,261,609,42.9,348,474,140,334,653,1284,991,24,"https://fbref.com/en/squads/d48ad4ff/2017-2018/Napoli-Stats"
2018,"Newcastle Utd","Premier League","team",27,38,645,426,338,255,52,221,638,34.6,417,475,117,358,441,1086,1219,17,"https://fbref.com/en/squads/b2b47a98/2017-2018/Newcastle-United-Stats"
2018,"Newcastle Utd","Premier League","opponent",27,38,640,429,306,248,86,229,533,43,304,389,118,271,379,1019,1058,25,"https://fbref.com/en/squads/b2b47a98/2017-2018/Newcastle-United-Stats"
2018,"Nice","Ligue 1","team",31,38,588,398,327,215,46,230,572,40.2,342,369,115,254,437,1025,687,32,"https://fbref.com/en/squads/132ebc33/2017-2018/Nice-Stats"
2018,"Nice","Ligue 1","opponent",31,38,671,442,320,270,81,243,747,32.5,504,394,119,275,484,1155,696,20,"https://fbref.com/en/squads/132ebc33/2017-2018/Nice-Stats"
2018,"Paris S-G","Ligue 1","team",28,38,646,435,285,264,97,213,594,35.9,381,322,97,225,329,975,620,19,"https://fbref.com/en/squads/e2d8892c/2017-2018/Paris-Saint-Germain-Stats"
2018,"Paris S-G","Ligue 1","opponent",28,38,732,479,377,276,79,297,935,31.8,638,437,133,304,540,1272,882,26,"https://fbref.com/en/squads/e2d8892c/2017-2018/Paris-Saint-Germain-Stats"
2018,"RB Leipzig","Bundesliga","team",23,34,698,509,318,309,71,342,617,55.4,275,471,76,395,397,1095,822,10,"https://fbref.com/en/squads/acbb6a5b/2017-2018/RB-Leipzig-Stats"
2018,"RB Leipzig","Bundesliga","opponent",23,34,826,590,400,349,77,405,769,52.7,364,486,102,384,448,1274,844,17,"https://fbref.com/en/squads/acbb6a5b/2017-2018/RB-Leipzig-Stats"
2018,"Real Madrid","La Liga","team",24,38,687,470,317,275,95,252,621,40.6,369,362,83,279,424,1111,536,16,"https://fbref.com/en/squads/53a2f082/2017-2018/Real-Madrid-Stats"
2018,"Real Madrid","La Liga","opponent",24,38,644,418,358,205,81,251,752,33.4,501,431,152,279,486,1130,974,17,"https://fbref.com/en/squads/53a2f082/2017-2018/Real-Madrid-Stats"
2018,"Real Sociedad","La Liga","team",27,38,547,374,249,228,70,227,536,42.4,309,367,91,276,446,993,665,6,"https://fbref.com/en/squads/e31d1cd9/2017-2018/Real-Sociedad-Stats"
2018,"Real Sociedad","La Liga","opponent",27,38,708,510,366,266,76,261,623,41.9,362,430,127,303,489,1197,855,13,"https://fbref.com/en/squads/e31d1cd9/2017-2018/Real-Sociedad-Stats"
2018,"Rennes","Ligue 1","team",28,38,656,409,295,277,84,263,747,35.2,484,408,89,319,415,1071,1012,19,"https://fbref.com/en/squads/b3072e00/2017-2018/Rennes-Stats"
2018,"Rennes","Ligue 1","opponent",28,38,656,439,349,262,45,239,591,40.4,352,353,106,247,455,1111,949,23,"https://fbref.com/en/squads/b3072e00/2017-2018/Rennes-Stats"
2018,"Roma","Serie A","team",27,38,548,384,251,212,85,183,470,38.9,287,320,104,216,477,1025,821,19,"https://fbref.com/en/squads/cf74a709/2017-2018/Roma-Stats"
2018,"Roma","Serie A","opponent",27,38,682,504,366,244,72,268,679,39.5,411,456,161,295,453,1135,1165,29,"https://fbref.com/en/squads/cf74a709/2017-2018/Roma-Stats"
2018,"SPAL","Serie A","team",29,38,586,414,308,217,61,209,539,38.8,330,389,145,244,527,1113,1111,11,"https://fbref.com/en/squads/1d2fe027/2017-2018/SPAL-Stats"
2018,"SPAL","Serie A","opponent",29,38,576,392,262,237,77,217,530,40.9,313,354,98,256,335,911,827,9,"https://fbref.com/en/squads/1d2fe027/2017-2018/SPAL-Stats"
2018,"Saint-Étienne","Ligue 1","team",30,38,679,447,364,253,62,243,680,35.7,437,400,121,279,401,1080,965,16,"https://fbref.com/en/squads/d298ef2c/2017-2018/Saint-Etienne-Stats"
2018,"Saint-Étienne","Ligue 1","opponent",30,38,702,452,343,276,83,213,584,36.5,371,417,96,321,493,1195,858,18,"https://fbref.com/en/squads/d298ef2c/2017-2018/Saint-Etienne-Stats"
2018,"Sampdoria","Serie A","team",27,38,624,423,254,274,96,223,600,37.2,377,505,117,388,335,959,856,25,"https://fbref.com/en/squads/8ff9e3b3/2017-2018/Sampdoria-Stats"
2018,"Sampdoria","Serie A","opponent",27,38,629,465,318,249,62,215,572,37.6,357,421,121,300,503,1132,1023,24,"https://fbref.com/en/squads/8ff9e3b3/2017-2018/Sampdoria-Stats"
2018,"Sassuolo","Serie A","team",28,38,568,375,294,208,66,204,594,34.3,390,396,98,298,506,1074,1085,16,"https://fbref.com/en/squads/e2befd26/2017-2018/Sassuolo-Stats"
2018,"Sassuolo","Serie A","opponent",28,38,635,450,335,228,72,207,537,38.5,330,437,135,302,389,1024,919,17,"https://fbref.com/en/squads/e2befd26/2017-2018/Sassuolo-Stats"
2018,"Schalke 04","Bundesliga","team",24,34,720,534,335,325,60,332,628,52.9,296,483,89,394,498,1218,773,15,"https://fbref.com/en/squads/c539e393/2017-2018/Schalke-04-Stats"
2018,"Schalke 04","Bundesliga","opponent",24,34,714,541,334,324,56,423,738,57.3,315,375,77,298,378,1092,630,9,"https://fbref.com/en/squads/c539e393/2017-2018/Schalke-04-Stats"
2018,"Sevilla","La Liga","team",31,38,768,535,354,325,89,296,685,43.2,389,419,114,305,409,1177,849,17,"https://fbref.com/en/squads/ad2be733/2017-2018/Sevilla-Stats"
2018,"Sevilla","La Liga","opponent",31,38,699,471,353,277,69,269,661,40.7,392,442,118,324,467,1166,851,12,"https://fbref.com/en/squads/ad2be733/2017-2018/Sevilla-Stats"
2018,"Southampton","Premier League","team",26,38,658,454,342,250,66,244,605,40.3,361,455,128,327,462,1120,1034,25,"https://fbref.com/en/squads/33c895d4/2017-2018/Southampton-Stats"
2018,"Southampton","Premier League","opponent",26,38,530,343,281,191,58,151,530,28.5,379,452,117,335,420,950,1057,19,"https://fbref.com/en/squads/33c895d4/2017-2018/Southampton-Stats"
2018,"Stoke City","Premier League","team",30,38,678,437,370,252,56,228,600,38,372,424,142,282,461,1139,1265,20,"https://fbref.com/en/squads/17892952/2017-2018/Stoke-City-Stats"
2018,"Stoke City","Premier League","opponent",30,38,585,408,281,237,67,182,507,35.9,325,346,96,250,330,915,908,17,"https://fbref.com/en/squads/17892952/2017-2018/Stoke-City-Stats"
2018,"Strasbourg","Ligue 1","team",25,38,750,490,388,298,64,243,661,36.8,418,360,91,269,515,1265,879,20,"https://fbref.com/en/squads/c0d3eab4/2017-2018/Strasbourg-Stats"
2018,"Strasbourg","Ligue 1","opponent",25,38,651,430,297,286,68,254,634,40.1,380,370,116,254,413,1064,1010,16,"https://fbref.com/en/squads/c0d3eab4/2017-2018/Strasbourg-Stats"
2018,"Stuttgart","Bundesliga","team",26,34,696,496,332,299,65,328,560,58.6,232,439,107,332,414,1110,814,17,"https://fbref.com/en/squads/598bc722/2017-2018/Stuttgart-Stats"
2018,"Stuttgart","Bundesliga","opponent",26,34,576,452,297,228,51,302,539,56,237,387,86,301,372,948,695,16,"https://fbref.com/en/squads/598bc722/2017-2018/Stuttgart-Stats"
2018,"Swansea City","Premier League","team",26,38,610,417,286,241,83,221,550,40.2,329,411,124,287,390,1000,1019,21,"https://fbref.com/en/squads/fb10988f/2017-2018/Swansea-City-Stats"
2018,"Swansea City","Premier League","opponent",26,38,644,423,322,245,77,205,523,39.2,318,379,102,277,399,1043,936,10,"https://fbref.com/en/squads/fb10988f/2017-2018/Swansea-City-Stats"
2018,"Torino","Serie A","team",27,38,609,405,295,256,58,182,465,39.1,283,380,112,268,421,1030,960,15,"https://fbref.com/en/squads/105360fe/2017-2018/Torino-Stats"
2018,"Torino","Serie A","opponent",27,38,737,508,354,295,88,259,677,38.3,418,449,103,346,415,1152,770,15,"https://fbref.com/en/squads/105360fe/2017-2018/Torino-Stats"
2018,"Tottenham","Premier League","team",25,38,618,399,272,259,87,212,537,39.5,325,360,74,286,380,998,878,22,"https://fbref.com/en/squads/361ca564/2017-2018/Tottenham-Hotspur-Stats"
2018,"Tottenham","Premier League","opponent",25,38,743,485,427,266,50,282,718,39.3,436,503,181,322,531,1274,1192,33,"https://fbref.com/en/squads/361ca564/2017-2018/Tottenham-Hotspur-Stats"
2018,"Toulouse","Ligue 1","team",25,38,699,465,349,275,75,254,662,38.4,408,392,101,291,479,1178,928,18,"https://fbref.com/en/squads/3f8c4b5f/2017-2018/Toulouse-Stats"
2018,"Toulouse","Ligue 1","opponent",25,38,692,455,352,271,69,290,682,42.5,392,393,97,296,408,1100,1158,12,"https://fbref.com/en/squads/3f8c4b5f/2017-2018/Toulouse-Stats"
2018,"Troyes","Ligue 1","team",25,38,657,410,365,221,71,225,673,33.4,448,383,129,254,437,1094,1094,18,"https://fbref.com/en/squads/54195385/2017-2018/Troyes-Stats"
2018,"Troyes","Ligue 1","opponent",25,38,650,441,281,278,91,257,568,45.2,311,384,80,304,476,1126,870,14,"https://fbref.com/en/squads/54195385/2017-2018/Troyes-Stats"
2018,"Udinese","Serie A","team",27,38,618,415,321,240,57,224,565,39.6,341,482,154,328,459,1077,992,13,"https://fbref.com/en/squads/04eea015/2017-2018/Udinese-Stats"
2018,"Udinese","Serie A","opponent",27,38,606,392,272,266,68,230,542,42.4,312,368,94,274,420,1026,898,12,"https://fbref.com/en/squads/04eea015/2017-2018/Udinese-Stats"
2018,"Valencia","La Liga","team",25,38,745,492,407,267,71,309,692,44.7,383,416,108,308,459,1204,910,9,"https://fbref.com/en/squads/dcc91a7b/2017-2018/Valencia-Stats"
2018,"Valencia","La Liga","opponent",25,38,746,488,335,312,99,271,699,38.8,428,364,108,256,542,1288,698,13,"https://fbref.com/en/squads/dcc91a7b/2017-2018/Valencia-Stats"
2018,"Villarreal","La Liga","team",32,38,711,466,356,278,77,277,700,39.6,423,447,131,316,427,1138,1023,7,"https://fbref.com/en/squads/2a8183b3/2017-2018/Villarreal-Stats"
2018,"Villarreal","La Liga","opponent",32,38,640,440,294,260,86,247,575,43,328,383,109,274,518,1158,696,9,"https://fbref.com/en/squads/2a8183b3/2017-2018/Villarreal-Stats"
2018,"Watford","Premier League","team",29,38,668,432,337,263,68,237,609,38.9,372,359,98,261,467,1135,997,17,"https://fbref.com/en/squads/2abfe087/2017-2018/Watford-Stats"
2018,"Watford","Premier League","opponent",29,38,643,426,315,261,67,233,565,41.2,332,463,115,348,439,1082,1183,18,"https://fbref.com/en/squads/2abfe087/2017-2018/Watford-Stats"
2018,"Werder Bremen","Bundesliga","team",25,34,600,435,288,264,48,294,528,55.7,234,353,77,276,421,1021,738,18,"https://fbref.com/en/squads/62add3bf/2017-2018/Werder-Bremen-Stats"
2018,"Werder Bremen","Bundesliga","opponent",25,34,614,471,296,271,47,273,477,57.2,204,498,114,384,357,971,799,10,"https://fbref.com/en/squads/62add3bf/2017-2018/Werder-Bremen-Stats"
2018,"West Brom","Premier League","team",24,38,603,385,336,204,63,218,625,34.9,407,420,148,272,470,1073,1087,9,"https://fbref.com/en/squads/60c6b05f/2017-2018/West-Bromwich-Albion-Stats"
2018,"West Brom","Premier League","opponent",24,38,652,424,314,260,78,205,526,39,321,323,88,235,344,996,1059,20,"https://fbref.com/en/squads/60c6b05f/2017-2018/West-Bromwich-Albion-Stats"
2018,"West Ham","Premier League","team",27,38,621,410,327,238,56,235,620,37.9,385,437,154,283,482,1103,1085,17,"https://fbref.com/en/squads/7c21e445/2017-2018/West-Ham-United-Stats"
2018,"West Ham","Premier League","opponent",27,38,606,423,285,250,71,219,642,34.1,423,378,89,289,370,976,1062,18,"https://fbref.com/en/squads/7c21e445/2017-2018/West-Ham-United-Stats"
2018,"Wolfsburg","Bundesliga","team",29,34,589,430,329,213,47,306,546,56,240,420,119,301,403,992,730,12,"https://fbref.com/en/squads/4eaa11d7/2017-2018/Wolfsburg-Stats"
2018,"Wolfsburg","Bundesliga","opponent",29,34,614,460,272,278,64,231,451,51.2,220,373,85,288,399,1013,618,9,"https://fbref.com/en/squads/4eaa11d7/2017-2018/Wolfsburg-Stats"
2019,"Alavés","La Liga","team",26,38,646,389,352,228,66,254,595,42.7,341,419,117,302,390,1036,1066,13,"https://fbref.com/en/squads/8d6fd021/2018-2019/Alaves-Stats"
2019,"Alavés","La Liga","opponent",26,38,554,330,259,240,55,213,489,43.6,276,363,91,272,364,918,859,10,"https://fbref.com/en/squads/8d6fd021/2018-2019/Alaves-Stats"
2019,"Amiens","Ligue 1","team",26,38,629,384,313,244,72,256,611,41.9,355,389,141,248,396,1025,876,16,"https://fbref.com/en/squads/25622401/2018-2019/Amiens-Stats"
2019,"Amiens","Ligue 1","opponent",26,38,630,380,296,262,72,228,485,47,257,353,99,254,406,1036,771,13,"https://fbref.com/en/squads/25622401/2018-2019/Amiens-Stats"
2019,"Angers","Ligue 1","team",24,38,673,399,351,254,68,259,623,41.6,364,396,109,287,420,1093,889,8,"https://fbref.com/en/squads/69236f98/2018-2019/Angers-Stats"
2019,"Angers","Ligue 1","opponent",24,38,691,427,321,298,72,245,561,43.7,316,373,107,266,412,1103,770,13,"https://fbref.com/en/squads/69236f98/2018-2019/Angers-Stats"
2019,"Arsenal","Premier League","team",28,38,609,366,294,236,79,228,535,42.6,307,424,118,306,412,1021,798,28,"https://fbref.com/en/squads/18bb7c10/2018-2019/Arsenal-Stats"
2019,"Arsenal","Premier League","opponent",28,38,641,362,306,247,88,232,536,43.3,304,496,132,364,525,1166,841,28,"https://fbref.com/en/squads/18bb7c10/2018-2019/Arsenal-Stats"
2019,"Atalanta","Serie A","team",27,38,638,397,278,277,83,269,577,46.6,308,433,96,337,454,1092,675,10,"https://fbref.com/en/squads/922493f3/2018-2019/Atalanta-Stats"
2019,"Atalanta","Serie A","opponent",27,38,755,458,416,275,64,291,654,44.5,363,475,153,322,472,1227,893,20,"https://fbref.com/en/squads/922493f3/2018-2019/Atalanta-Stats"
2019,"Athletic Club","La Liga","team",27,38,643,384,311,245,87,245,646,37.9,401,414,93,321,453,1096,815,7,"https://fbref.com/en/squads/2b390eca/2018-2019/Athletic-Club-Stats"
2019,"Athletic Club","La Liga","opponent",27,38,598,402,290,234,74,254,542,46.9,288,375,81,294,355,953,868,8,"https://fbref.com/en/squads/2b390eca/2018-2019/Athletic-Club-Stats"
2019,"Atlético Madrid","La Liga","team",29,38,784,487,402,298,84,319,700,45.6,381,374,94,280,463,1247,837,12,"https://fbref.com/en/squads/db3b9613/2018-2019/Atletico-Madrid-Stats"
2019,"Atlético Madrid","La Liga","opponent",29,38,617,383,331,212,74,205,571,35.9,366,394,100,294,436,1053,817,9,"https://fbref.com/en/squads/db3b9613/2018-2019/Atletico-Madrid-Stats"
2019,"Augsburg","Bundesliga","team",30,34,591,376,280,262,49,238,515,46.2,277,404,130,274,467,1058,754,15,"https://fbref.com/en/squads/0cdc4311/2018-2019/Augsburg-Stats"
2019,"Augsburg","Bundesliga","opponent",30,34,526,328,241,217,68,190,407,46.7,217,406,92,314,394,920,710,16,"https://fbref.com/en/squads/0cdc4311/2018-2019/Augsburg-Stats"
2019,"Barcelona","La Liga","team",30,38,537,346,218,232,87,226,492,45.9,266,360,101,259,391,928,565,16,"https://fbref.com/en/squads/206d90db/2018-2019/Barcelona-Stats"
2019,"Barcelona","La Liga","opponent",30,38,742,435,426,252,64,307,753,40.8,446,438,106,332,545,1287,689,23,"https://fbref.com/en/squads/206d90db/2018-2019/Barcelona-Stats"
2019,"Bayern Munich","Bundesliga","team",24,34,465,294,172,210,83,165,410,40.2,245,313,61,252,336,801,368,10,"https://fbref.com/en/squads/054efa67/2018-2019/Bayern-Munich-Stats"
2019,"Bayern Munich","Bundesliga","opponent",24,34,572,366,364,169,39,257,683,37.6,426,467,131,336,382,954,935,20,"https://fbref.com/en/squads/054efa67/2018-2019/Bayern-Munich-Stats"
2019,"Betis","La Liga","team",25,38,615,378,309,227,79,219,544,40.3,325,382,80,302,361,976,702,21,"https://fbref.com/en/squads/fc536746/2018-2019/Real-Betis-Stats"
2019,"Betis","La Liga","opponent",25,38,659,392,318,258,83,267,716,37.3,449,421,114,307,424,1083,757,16,"https://fbref.com/en/squads/fc536746/2018-2019/Real-Betis-Stats"
2019,"Bologna","Serie A","team",29,38,689,430,365,252,72,262,631,41.5,369,463,142,321,372,1061,863,17,"https://fbref.com/en/squads/1d8099f8/2018-2019/Bologna-Stats"
2019,"Bologna","Serie A","opponent",29,38,629,409,310,238,81,269,542,49.6,273,380,125,255,369,998,874,14,"https://fbref.com/en/squads/1d8099f8/2018-2019/Bologna-Stats"
2019,"Bordeaux","Ligue 1","team",33,38,720,447,359,303,58,296,666,44.4,370,394,114,280,391,1111,966,20,"https://fbref.com/en/squads/123f3efe/2018-2019/Bordeaux-Stats"
2019,"Bordeaux","Ligue 1","opponent",33,38,739,481,316,323,100,312,657,47.5,345,401,96,305,369,1108,746,14,"https://fbref.com/en/squads/123f3efe/2018-2019/Bordeaux-Stats"
2019,"Bournemouth","Premier League","team",28,38,525,299,285,185,55,216,494,43.7,278,405,152,253,371,896,1098,21,"https://fbref.com/en/squads/4ba7cbea/2018-2019/Bournemouth-Stats"
2019,"Bournemouth","Premier League","opponent",28,38,643,388,297,272,74,287,578,49.7,291,472,102,370,423,1066,830,14,"https://fbref.com/en/squads/4ba7cbea/2018-2019/Bournemouth-Stats"
2019,"Brighton","Premier League","team",21,38,679,391,363,238,78,264,582,45.4,318,415,170,245,463,1142,1001,17,"https://fbref.com/en/squads/d07537b9/2018-2019/Brighton-and-Hove-Albion-Stats"
2019,"Brighton","Premier League","opponent",21,38,583,346,272,223,88,247,516,47.9,269,367,87,280,399,982,711,13,"https://fbref.com/en/squads/d07537b9/2018-2019/Brighton-and-Hove-Albion-Stats"
2019,"Burnley","Premier League","team",23,38,584,311,280,246,58,237,539,44,302,516,222,294,367,951,1156,19,"https://fbref.com/en/squads/943e8050/2018-2019/Burnley-Stats"
2019,"Burnley","Premier League","opponent",23,38,477,291,236,189,52,163,370,44.1,207,329,84,245,307,784,952,11,"https://fbref.com/en/squads/943e8050/2018-2019/Burnley-Stats"
2019,"Caen","Ligue 1","team",26,38,709,435,373,271,65,291,621,46.9,330,403,141,262,489,1198,952,18,"https://fbref.com/en/squads/74229020/2018-2019/Caen-Stats"
2019,"Caen","Ligue 1","opponent",26,38,679,386,284,313,82,267,535,49.9,268,337,95,242,330,1009,815,3,"https://fbref.com/en/squads/74229020/2018-2019/Caen-Stats"
2019,"Cagliari","Serie A","team",30,38,603,388,259,249,95,211,524,40.3,313,449,126,323,344,947,837,4,"https://fbref.com/en/squads/c4260e09/2018-2019/Cagliari-Stats"
2019,"Cagliari","Serie A","opponent",30,38,534,306,251,222,61,166,346,48,180,365,95,270,377,911,860,8,"https://fbref.com/en/squads/c4260e09/2018-2019/Cagliari-Stats"
2019,"Cardiff City","Premier League","team",25,38,655,375,357,234,64,241,607,39.7,366,490,147,343,529,1184,1034,18,"https://fbref.com/en/squads/75fae011/2018-2019/Cardiff-City-Stats"
2019,"Cardiff City","Premier League","opponent",25,38,546,326,283,217,46,214,474,45.1,260,373,117,256,314,860,987,15,"https://fbref.com/en/squads/75fae011/2018-2019/Cardiff-City-Stats"
2019,"Celta Vigo","La Liga","team",28,38,634,377,364,213,57,258,562,45.9,304,380,105,275,382,1016,889,19,"https://fbref.com/en/squads/f25da7fb/2018-2019/Celta-Vigo-Stats"
2019,"Celta Vigo","La Liga","opponent",28,38,617,379,290,250,77,246,626,39.3,380,386,120,266,361,978,727,13,"https://fbref.com/en/squads/f25da7fb/2018-2019/Celta-Vigo-Stats"
2019,"Chelsea","Premier League","team",24,38,618,365,280,245,93,241,541,44.5,300,357,73,284,353,971,645,16,"https://fbref.com/en/squads/cff3d9bb/2018-2019/Chelsea-Stats"
2019,"Chelsea","Premier League","opponent",24,38,712,403,371,266,75,253,702,36,449,561,194,367,568,1280,978,21,"https://fbref.com/en/squads/cff3d9bb/2018-2019/Chelsea-Stats"
2019,"Chievo","Serie A","team",36,38,623,374,320,243,60,252,605,41.7,353,421,132,289,471,1094,988,18,"https://fbref.com/en/squads/cc919b35/2018-2019/Chievo-Stats"
2019,"Chievo","Serie A","opponent",36,38,522,315,210,248,64,164,365,44.9,201,343,85,258,344,866,715,4,"https://fbref.com/en/squads/cc919b35/2018-2019/Chievo-Stats"
2019,"Crystal Palace","Premier League","team",26,38,733,446,398,270,65,281,590,47.6,309,441,141,300,445,1178,1011,17,"https://fbref.com/en/squads/47c64c55/2018-2019/Crystal-Palace-Stats"
2019,"Crystal Palace","Premier League","opponent",26,38,763,422,358,307,98,290,667,43.5,377,432,132,300,426,1189,886,14,"https://fbref.com/en/squads/47c64c55/2018-2019/Crystal-Palace-Stats"
2019,"Dijon","Ligue 1","team",26,38,674,408,339,254,81,261,645,40.5,384,417,119,298,482,1156,826,14,"https://fbref.com/en/squads/8dfb7350/2018-2019/Dijon-Stats"
2019,"Dijon","Ligue 1","opponent",26,38,635,390,292,279,64,252,602,41.9,350,375,105,270,359,994,796,12,"https://fbref.com/en/squads/8dfb7350/2018-2019/Dijon-Stats"
2019,"Dortmund","Bundesliga","team",23,34,497,319,242,194,61,181,402,45,221,334,79,255,384,881,659,17,"https://fbref.com/en/squads/add600ae/2018-2019/Dortmund-Stats"
2019,"Dortmund","Bundesliga","opponent",23,34,678,442,326,283,69,297,737,40.3,440,475,114,361,395,1073,631,13,"https://fbref.com/en/squads/add600ae/2018-2019/Dortmund-Stats"
2019,"Düsseldorf","Bundesliga","team",24,34,625,384,345,233,47,250,621,40.3,371,374,107,267,419,1044,760,14,"https://fbref.com/en/squads/b1278397/2018-2019/Dusseldorf-Stats"
2019,"Düsseldorf","Bundesliga","opponent",24,34,460,316,192,204,64,203,435,46.7,232,342,91,251,332,792,583,10,"https://fbref.com/en/squads/b1278397/2018-2019/Dusseldorf-Stats"
2019,"Eibar","La Liga","team",25,38,637,424,238,289,110,240,563,42.6,323,357,53,304,368,1005,683,10,"https://fbref.com/en/squads/bea5c710/2018-2019/Eibar-Stats"
2019,"Eibar","La Liga","opponent",25,38,635,393,387,197,51,248,592,41.9,344,453,98,355,474,1109,1263,15,"https://fbref.com/en/squads/bea5c710/2018-2019/Eibar-Stats"
2019,"Eint Frankfurt","Bundesliga","team",30,34,598,371,291,246,61,233,539,43.2,306,465,102,363,360,958,708,4,"https://fbref.com/en/squads/f0ac8ee6/2018-2019/Eintracht-Frankfurt-Stats"
2019,"Eint Frankfurt","Bundesliga","opponent",30,34,594,348,327,223,44,229,522,43.9,293,409,90,319,440,1034,787,8,"https://fbref.com/en/squads/f0ac8ee6/2018-2019/Eintracht-Frankfurt-Stats"
2019,"Empoli","Serie A","team",29,38,552,328,257,223,72,216,510,42.4,294,353,133,220,333,885,797,10,"https://fbref.com/en/squads/a3d88bd8/2018-2019/Empoli-Stats"
2019,"Empoli","Serie A","opponent",29,38,590,373,298,230,62,223,556,40.1,333,444,127,317,406,996,750,10,"https://fbref.com/en/squads/a3d88bd8/2018-2019/Empoli-Stats"
2019,"Espanyol","La Liga","team",25,38,655,394,324,244,87,263,684,38.5,421,402,134,268,408,1063,950,14,"https://fbref.com/en/squads/a8661628/2018-2019/Espanyol-Stats"
2019,"Espanyol","La Liga","opponent",25,38,578,382,275,208,95,204,522,39.1,318,441,113,328,420,998,690,17,"https://fbref.com/en/squads/a8661628/2018-2019/Espanyol-Stats"
2019,"Everton","Premier League","team",23,38,699,441,326,290,83,220,511,43.1,291,414,85,329,453,1152,877,21,"https://fbref.com/en/squads/d3fd31cc/2018-2019/Everton-Stats"
2019,"Everton","Premier League","opponent",23,38,728,430,329,324,75,258,586,44,328,462,139,323,410,1138,1046,20,"https://fbref.com/en/squads/d3fd31cc/2018-2019/Everton-Stats"
2019,"Fiorentina","Serie A","team",27,38,592,371,272,238,82,199,470,42.3,271,401,130,271,413,1005,887,11,"https://fbref.com/en/squads/421387cf/2018-2019/Fiorentina-Stats"
2019,"Fiorentina","Serie A","opponent",27,38,661,408,343,238,80,284,590,48.1,306,412,154,258,383,1044,916,15,"https://fbref.com/en/squads/421387cf/2018-2019/Fiorentina-Stats"
2019,"Freiburg","Bundesliga","team",28,34,570,357,301,211,58,213,503,42.3,290,401,121,280,374,944,882,12,"https://fbref.com/en/squads/a486e511/2018-2019/Freiburg-Stats"
2019,"Freiburg","Bundesliga","opponent",28,34,505,335,220,224,61,205,441,46.5,236,374,106,268,339,844,647,14,"https://fbref.com/en/squads/a486e511/2018-2019/Freiburg-Stats"
2019,"Frosinone","Serie A","team",33,38,571,353,303,204,64,213,530,40.2,317,416,151,265,384,955,918,12,"https://fbref.com/en/squads/6a7ad59d/2018-2019/Frosinone-Stats"
2019,"Frosinone","Serie A","opponent",33,38,562,342,256,239,67,214,427,50.1,213,384,114,270,334,896,820,13,"https://fbref.com/en/squads/6a7ad59d/2018-2019/Frosinone-Stats"
2019,"Fulham","Premier League","team",28,38,596,362,310,231,55,224,524,42.7,300,425,144,281,434,1030,1030,28,"https://fbref.com/en/squads/fd962109/2018-2019/Fulham-Stats"
2019,"Fulham","Premier League","opponent",28,38,700,428,298,306,96,214,566,37.8,352,377,110,267,446,1146,765,18,"https://fbref.com/en/squads/fd962109/2018-2019/Fulham-Stats"
2019,"Genoa","Serie A","team",31,38,670,424,329,249,92,253,541,46.8,288,377,114,263,424,1094,858,10,"https://fbref.com/en/squads/658bf2de/2018-2019/Genoa-Stats"
2019,"Genoa","Serie A","opponent",31,38,541,340,272,216,53,212,501,42.3,289,381,131,250,350,891,981,10,"https://fbref.com/en/squads/658bf2de/2018-2019/Genoa-Stats"
2019,"Getafe","La Liga","team",26,38,604,358,246,281,77,255,617,41.3,362,422,81,341,453,1057,888,15,"https://fbref.com/en/squads/7848bd64/2018-2019/Getafe-Stats"
2019,"Getafe","La Liga","opponent",26,38,643,389,336,240,67,277,576,48.1,299,416,97,319,342,985,878,14,"https://fbref.com/en/squads/7848bd64/2018-2019/Getafe-Stats"
2019,"Girona","La Liga","team",26,38,613,367,309,247,57,264,636,41.5,372,401,124,277,432,1045,928,14,"https://fbref.com/en/squads/9024a00a/2018-2019/Girona-Stats"
2019,"Girona","La Liga","opponent",26,38,591,366,304,234,53,221,537,41.2,316,311,75,236,407,998,858,17,"https://fbref.com/en/squads/9024a00a/2018-2019/Girona-Stats"
2019,"Guingamp","Ligue 1","team",30,38,684,431,320,299,65,275,551,49.9,276,416,112,304,421,1105,768,17,"https://fbref.com/en/squads/d41b5f53/2018-2019/Guingamp-Stats"
2019,"Guingamp","Ligue 1","opponent",30,38,694,431,375,253,66,219,573,38.2,354,369,116,253,414,1108,978,13,"https://fbref.com/en/squads/d41b5f53/2018-2019/Guingamp-Stats"
2019,"Hannover 96","Bundesliga","team",32,34,583,342,305,228,50,262,628,41.7,366,434,124,310,459,1042,797,10,"https://fbref.com/en/squads/60b5e41f/2018-2019/Hannover-96-Stats"
2019,"Hannover 96","Bundesliga","opponent",32,34,641,396,290,284,67,252,529,47.6,277,405,97,308,361,1002,635,11,"https://fbref.com/en/squads/60b5e41f/2018-2019/Hannover-96-Stats"
2019,"Hertha BSC","Bundesliga","team",26,34,538,352,251,235,52,178,451,39.5,273,423,117,306,381,919,823,7,"https://fbref.com/en/squads/2818f8bc/2018-2019/Hertha-BSC-Stats"
2019,"Hertha BSC","Bundesliga","opponent",26,34,541,318,265,229,47,209,514,40.7,305,360,86,274,368,909,692,10,"https://fbref.com/en/squads/2818f8bc/2018-2019/Hertha-BSC-Stats"
2019,"Hoffenheim","Bundesliga","team",29,34,571,363,260,237,74,206,528,39,322,419,104,315,399,970,638,13,"https://fbref.com/en/squads/033ea6b8/2018-2019/Hoffenheim-Stats"
2019,"Hoffenheim","Bundesliga","opponent",29,34,601,354,317,209,75,240,596,40.3,356,428,127,301,428,1029,815,11,"https://fbref.com/en/squads/033ea6b8/2018-2019/Hoffenheim-Stats"
2019,"Huddersfield","Premier League","team",31,38,708,425,323,315,70,263,625,42.1,362,496,130,366,531,1239,682,15,"https://fbref.com/en/squads/f5922ca5/2018-2019/Huddersfield-Town-Stats"
2019,"Huddersfield","Premier League","opponent",31,38,612,387,302,269,41,213,443,48.1,230,437,115,322,427,1039,1014,19,"https://fbref.com/en/squads/f5922ca5/2018-2019/Huddersfield-Town-Stats"
2019,"Huesca","La Liga","team",30,38,712,452,363,290,59,303,694,43.7,391,414,107,307,440,1152,953,12,"https://fbref.com/en/squads/c6c493e6/2018-2019/Huesca-Stats"
2019,"Huesca","La Liga","opponent",30,38,634,399,291,272,71,278,592,47,314,383,102,281,374,1008,913,9,"https://fbref.com/en/squads/c6c493e6/2018-2019/Huesca-Stats"
2019,"Inter","Serie A","team",23,38,614,409,278,244,92,253,596,42.4,343,388,104,284,311,925,642,14,"https://fbref.com/en/squads/d609edc0/2018-2019/Internazionale-Stats"
2019,"Inter","Serie A","opponent",23,38,535,341,285,178,72,225,510,44.1,285,445,166,279,434,969,1133,16,"https://fbref.com/en/squads/d609edc0/2018-2019/Internazionale-Stats"
2019,"Juventus","Serie A","team",31,38,571,355,259,234,78,213,452,47.1,239,383,130,253,396,967,681,16,"https://fbref.com/en/squads/e0652b02/2018-2019/Juventus-Stats"
2019,"Juventus","Serie A","opponent",31,38,581,372,285,212,84,261,637,41,376,418,153,265,362,943,913,15,"https://fbref.com/en/squads/e0652b02/2018-2019/Juventus-Stats"
2019,"Lazio","Serie A","team",30,38,658,406,295,284,79,280,599,46.7,319,415,136,279,432,1090,798,14,"https://fbref.com/en/squads/7213da33/2018-2019/Lazio-Stats"
2019,"Lazio","Serie A","opponent",30,38,600,377,324,216,60,268,612,43.8,344,471,163,308,439,1039,885,13,"https://fbref.com/en/squads/7213da33/2018-2019/Lazio-Stats"
2019,"Leganés","La Liga","team",29,38,609,382,325,221,63,227,581,39.1,354,329,84,245,432,1041,907,10,"https://fbref.com/en/squads/7c6f2c78/2018-2019/Leganes-Stats"
2019,"Leganés","La Liga","opponent",29,38,520,342,255,198,67,216,469,46.1,253,319,78,241,351,871,916,11,"https://fbref.com/en/squads/7c6f2c78/2018-2019/Leganes-Stats"
2019,"Leicester City","Premier League","team",25,38,675,393,344,277,54,237,549,43.2,312,429,96,333,438,1113,1034,24,"https://fbref.com/en/squads/a2d435b3/2018-2019/Leicester-City-Stats"
2019,"Leicester City","Premier League","opponent",25,38,629,378,292,262,75,272,664,41,392,434,134,300,480,1109,928,19,"https://fbref.com/en/squads/a2d435b3/2018-2019/Leicester-City-Stats"
2019,"Levante","La Liga","team",26,38,572,372,308,196,68,264,722,36.6,458,455,151,304,422,994,842,12,"https://fbref.com/en/squads/9800b6a1/2018-2019/Levante-Stats"
2019,"Levante","La Liga","opponent",26,38,765,480,367,296,102,336,738,45.5,402,397,106,291,397,1162,825,12,"https://fbref.com/en/squads/9800b6a1/2018-2019/Levante-Stats"
2019,"Leverkusen","Bundesliga","team",21,34,583,368,298,217,68,230,543,42.4,313,416,96,320,358,941,687,7,"https://fbref.com/en/squads/c7a9f859/2018-2019/Bayer-Leverkusen-Stats"
2019,"Leverkusen","Bundesliga","opponent",21,34,623,379,286,286,51,229,555,41.3,326,483,109,374,490,1113,764,15,"https://fbref.com/en/squads/c7a9f859/2018-2019/Bayer-Leverkusen-Stats"
2019,"Lille","Ligue 1","team",25,38,628,378,295,272,61,263,583,45.1,320,377,106,271,387,1015,764,15,"https://fbref.com/en/squads/cb188c0c/2018-2019/Lille-Stats"
2019,"Lille","Ligue 1","opponent",25,38,728,465,353,296,79,267,632,42.2,365,383,104,279,467,1195,725,15,"https://fbref.com/en/squads/cb188c0c/2018-2019/Lille-Stats"
2019,"Liverpool","Premier League","team",23,38,613,377,257,280,76,251,556,45.1,305,361,78,283,314,927,670,16,"https://fbref.com/en/squads/822bd0ba/2018-2019/Liverpool-Stats"
2019,"Liverpool","Premier League","opponent",23,38,687,412,411,231,45,263,619,42.5,356,477,141,336,499,1186,1101,21,"https://fbref.com/en/squads/822bd0ba/2018-2019/Liverpool-Stats"
2019,"Lyon","Ligue 1","team",25,38,637,384,285,266,86,231,492,47,261,406,136,270,363,1000,680,19,"https://fbref.com/en/squads/d53c0b06/2018-2019/Lyon-Stats"
2019,"Lyon","Ligue 1","opponent",25,38,755,426,392,283,80,301,764,39.4,463,454,160,294,517,1272,781,19,"https://fbref.com/en/squads/d53c0b06/2018-2019/Lyon-Stats"
2019,"M'Gladbach","Bundesliga","team",22,34,498,292,258,192,48,198,466,42.5,268,382,102,280,310,808,648,18,"https://fbref.com/en/squads/32f3ee20/2018-2019/Monchengladbach-Stats"
2019,"M'Gladbach","Bundesliga","opponent",22,34,507,318,246,196,65,207,487,42.5,280,398,115,283,370,877,703,15,"https://fbref.com/en/squads/32f3ee20/2018-2019/Monchengladbach-Stats"
2019,"Mainz 05","Bundesliga","team",28,34,528,309,256,219,53,220,467,47.1,247,455,123,332,395,923,728,12,"https://fbref.com/en/squads/a224b06a/2018-2019/Mainz-05-Stats"
2019,"Mainz 05","Bundesliga","opponent",28,34,633,397,323,236,74,240,556,43.2,316,388,117,271,351,984,809,9,"https://fbref.com/en/squads/a224b06a/2018-2019/Mainz-05-Stats"
2019,"Manchester City","Premier League","team",21,38,518,327,214,215,89,193,467,41.3,274,319,63,256,362,880,570,15,"https://fbref.com/en/squads/b8fd03ef/2018-2019/Manchester-City-Stats"
2019,"Manchester City","Premier League","opponent",21,38,688,379,469,192,27,296,733,40.4,437,493,191,302,448,1136,1133,27,"https://fbref.com/en/squads/b8fd03ef/2018-2019/Manchester-City-Stats"
2019,"Manchester Utd","Premier League","team",28,38,581,347,280,239,62,240,544,44.1,304,445,128,317,355,936,847,26,"https://fbref.com/en/squads/19538871/2018-2019/Manchester-United-Stats"
2019,"Manchester Utd","Premier League","opponent",28,38,655,385,330,249,76,231,552,41.8,321,430,129,301,442,1097,898,21,"https://fbref.com/en/squads/19538871/2018-2019/Manchester-United-Stats"
2019,"Marseille","Ligue 1","team",24,38,781,489,349,332,100,318,698,45.6,380,346,98,248,401,1182,690,18,"https://fbref.com/en/squads/5725cc7b/2018-2019/Marseille-Stats"
2019,"Marseille","Ligue 1","opponent",24,38,666,417,353,256,57,299,654,45.7,355,380,126,254,440,1106,904,11,"https://fbref.com/en/squads/5725cc7b/2018-2019/Marseille-Stats"
2019,"Milan","Serie A","team",23,38,641,382,336,233,72,268,559,47.9,291,408,109,299,373,1014,845,14,"https://fbref.com/en/squads/dc56fe14/2018-2019/Milan-Stats"
2019,"Milan","Serie A","opponent",23,38,617,382,292,243,82,202,543,37.2,341,427,161,266,428,1045,801,10,"https://fbref.com/en/squads/dc56fe14/2018-2019/Milan-Stats"
2019,"Monaco","Ligue 1","team",42,38,686,422,322,271,93,301,660,45.6,359,334,86,248,386,1072,841,15,"https://fbref.com/en/squads/fd6114db/2018-2019/Monaco-Stats"
2019,"Monaco","Ligue 1","opponent",42,38,632,379,317,240,75,282,574,49.1,292,421,131,290,449,1081,807,21,"https://fbref.com/en/squads/fd6114db/2018-2019/Monaco-Stats"
2019,"Montpellier","Ligue 1","team",25,38,759,431,364,305,90,304,676,45,372,411,105,306,484,1243,751,11,"https://fbref.com/en/squads/281b0e73/2018-2019/Montpellier-Stats"
2019,"Montpellier","Ligue 1","opponent",25,38,647,410,328,254,65,260,563,46.2,303,402,114,288,409,1056,906,15,"https://fbref.com/en/squads/281b0e73/2018-2019/Montpellier-Stats"
2019,"Nantes","Ligue 1","team",33,38,767,478,360,315,92,321,690,46.5,369,382,106,276,435,1202,831,6,"https://fbref.com/en/squads/d7a486cd/2018-2019/Nantes-Stats"
2019,"Nantes","Ligue 1","opponent",33,38,623,400,310,253,60,227,507,44.8,280,445,136,309,494,1117,871,15,"https://fbref.com/en/squads/d7a486cd/2018-2019/Nantes-Stats"
2019,"Napoli","Serie A","team",26,38,574,359,233,254,87,223,553,40.3,330,353,107,246,358,932,645,8,"https://fbref.com/en/squads/d48ad4ff/2018-2019/Napoli-Stats"
2019,"Napoli","Serie A","opponent",26,38,559,347,274,201,84,234,570,41.1,336,469,168,301,442,1001,864,18,"https://fbref.com/en/squads/d48ad4ff/2018-2019/Napoli-Stats"
2019,"Newcastle Utd","Premier League","team",24,38,711,433,356,291,64,241,565,42.7,324,472,135,337,506,1217,1204,16,"https://fbref.com/en/squads/b2b47a98/2018-2019/Newcastle-United-Stats"
2019,"Newcastle Utd","Premier League","opponent",24,38,608,367,281,257,70,207,443,46.7,236,389,116,273,351,959,922,18,"https://fbref.com/en/squads/b2b47a98/2018-2019/Newcastle-United-Stats"
2019,"Nice","Ligue 1","team",30,38,662,420,331,264,67,287,617,46.5,330,410,108,302,450,1112,777,11,"https://fbref.com/en/squads/132ebc33/2018-2019/Nice-Stats"
2019,"Nice","Ligue 1","opponent",30,38,830,483,400,344,86,421,927,45.4,506,385,119,266,400,1230,580,10,"https://fbref.com/en/squads/132ebc33/2018-2019/Nice-Stats"
2019,"Nîmes","Ligue 1","team",23,38,733,442,373,282,78,325,757,42.9,432,378,119,259,443,1176,832,8,"https://fbref.com/en/squads/1cbf5f9e/2018-2019/Nimes-Stats"
2019,"Nîmes","Ligue 1","opponent",23,38,723,447,349,294,80,319,681,46.8,362,391,120,271,398,1121,922,15,"https://fbref.com/en/squads/1cbf5f9e/2018-2019/Nimes-Stats"
2019,"Nürnberg","Bundesliga","team",27,34,551,350,335,175,41,253,560,45.2,307,382,119,263,354,905,840,12,"https://fbref.com/en/squads/6f2c108c/2018-2019/Nurnberg-Stats"
2019,"Nürnberg","Bundesliga","opponent",27,34,508,317,204,221,83,215,468,45.9,253,351,100,251,358,866,698,5,"https://fbref.com/en/squads/6f2c108c/2018-2019/Nurnberg-Stats"
2019,"Paris S-G","Ligue 1","team",30,38,701,434,286,315,100,282,625,45.1,343,335,93,242,342,1043,535,20,"https://fbref.com/en/squads/e2d8892c/2018-2019/Paris-Saint-Germain-Stats"
2019,"Paris S-G","Ligue 1","opponent",30,38,749,482,410,261,78,295,748,39.4,453,372,115,257,493,1242,788,20,"https://fbref.com/en/squads/e2d8892c/2018-2019/Paris-Saint-Germain-Stats"
2019,"Parma","Serie A","team",31,38,580,351,329,197,54,195,500,39,305,445,182,263,399,979,1147,12,"https://fbref.com/en/squads/eab4234c/2018-2019/Parma-Stats"
2019,"Parma","Serie A","opponent",31,38,613,408,262,246,105,238,517,46,279,365,88,277,338,951,617,12,"https://fbref.com/en/squads/eab4234c/2018-2019/Parma-Stats"
2019,"RB Leipzig","Bundesliga","team",23,34,657,398,300,279,78,282,580,48.6,298,455,70,385,416,1073,717,1,"https://fbref.com/en/squads/acbb6a5b/2018-2019/RB-Leipzig-Stats"
2019,"RB Leipzig","Bundesliga","opponent",23,34,634,381,342,235,57,243,555,43.8,312,466,114,352,496,1130,753,9,"https://fbref.com/en/squads/acbb6a5b/2018-2019/RB-Leipzig-Stats"
2019,"Rayo Vallecano","La Liga","team",29,38,651,422,369,223,59,257,592,43.4,335,388,77,311,433,1084,931,16,"https://fbref.com/en/squads/98e8af82/2018-2019/Rayo-Vallecano-Stats"
2019,"Rayo Vallecano","La Liga","opponent",29,38,809,491,335,354,120,314,848,37,534,380,120,260,371,1180,768,15,"https://fbref.com/en/squads/98e8af82/2018-2019/Rayo-Vallecano-Stats"
2019,"Real Madrid","La Liga","team",27,38,626,395,267,253,106,245,629,39,384,374,78,296,373,999,602,11,"https://fbref.com/en/squads/53a2f082/2018-2019/Real-Madrid-Stats"
2019,"Real Madrid","La Liga","opponent",27,38,651,397,334,243,74,295,755,39.1,460,465,148,317,449,1100,856,18,"https://fbref.com/en/squads/53a2f082/2018-2019/Real-Madrid-Stats"
2019,"Real Sociedad","La Liga","team",30,38,579,344,299,219,61,248,584,42.5,336,444,109,335,425,1004,842,19,"https://fbref.com/en/squads/e31d1cd9/2018-2019/Real-Sociedad-Stats"
2019,"Real Sociedad","La Liga","opponent",30,38,733,478,349,290,94,267,678,39.4,411,406,89,317,390,1123,721,11,"https://fbref.com/en/squads/e31d1cd9/2018-2019/Real-Sociedad-Stats"
2019,"Reims","Ligue 1","team",27,38,760,454,423,257,80,291,647,45,356,364,111,253,486,1246,886,18,"https://fbref.com/en/squads/7fdd64e0/2018-2019/Reims-Stats"
2019,"Reims","Ligue 1","opponent",27,38,607,384,257,257,93,269,588,45.7,319,341,84,257,412,1019,779,16,"https://fbref.com/en/squads/7fdd64e0/2018-2019/Reims-Stats"
2019,"Rennes","Ligue 1","team",28,38,652,395,307,271,74,292,650,44.9,358,405,119,286,389,1041,779,10,"https://fbref.com/en/squads/b3072e00/2018-2019/Rennes-Stats"
2019,"Rennes","Ligue 1","opponent",28,38,751,441,368,295,88,378,768,49.2,390,372,106,266,389,1140,787,17,"https://fbref.com/en/squads/b3072e00/2018-2019/Rennes-Stats"
2019,"Roma","Serie A","team",26,38,535,344,246,212,77,199,479,41.5,280,389,154,235,419,954,822,16,"https://fbref.com/en/squads/cf74a709/2018-2019/Roma-Stats"
2019,"Roma","Serie A","opponent",26,38,624,403,314,246,64,276,639,43.2,363,381,138,243,393,1017,887,17,"https://fbref.com/en/squads/cf74a709/2018-2019/Roma-Stats"
2019,"SPAL","Serie A","team",28,38,579,374,314,201,64,218,493,44.2,275,411,136,275,388,967,877,15,"https://fbref.com/en/squads/1d2fe027/2018-2019/SPAL-Stats"
2019,"SPAL","Serie A","opponent",28,38,615,406,275,248,92,218,492,44.3,274,404,115,289,342,957,797,8,"https://fbref.com/en/squads/1d2fe027/2018-2019/SPAL-Stats"
2019,"Saint-Étienne","Ligue 1","team",29,38,672,406,307,272,93,278,633,43.9,355,357,97,260,441,1113,774,24,"https://fbref.com/en/squads/d298ef2c/2018-2019/Saint-Etienne-Stats"
2019,"Saint-Étienne","Ligue 1","opponent",29,38,662,406,327,248,87,254,568,44.7,314,396,140,256,451,1113,811,24,"https://fbref.com/en/squads/d298ef2c/2018-2019/Saint-Etienne-Stats"
2019,"Sampdoria","Serie A","team",24,38,647,425,290,258,99,276,567,48.7,291,418,122,296,364,1011,838,9,"https://fbref.com/en/squads/8ff9e3b3/2018-2019/Sampdoria-Stats"
2019,"Sampdoria","Serie A","opponent",24,38,653,386,309,265,79,192,478,40.2,286,455,113,342,508,1161,801,14,"https://fbref.com/en/squads/8ff9e3b3/2018-2019/Sampdoria-Stats"
2019,"Sassuolo","Serie A","team",29,38,529,328,288,175,66,216,517,41.8,301,387,110,277,378,907,841,15,"https://fbref.com/en/squads/e2befd26/2018-2019/Sassuolo-Stats"
2019,"Sassuolo","Serie A","opponent",29,38,660,396,296,264,100,272,631,43.1,359,429,128,301,409,1069,745,15,"https://fbref.com/en/squads/e2befd26/2018-2019/Sassuolo-Stats"
2019,"Schalke 04","Bundesliga","team",32,34,631,381,279,286,66,251,594,42.3,343,464,119,345,419,1050,657,16,"https://fbref.com/en/squads/c539e393/2018-2019/Schalke-04-Stats"
2019,"Schalke 04","Bundesliga","opponent",32,34,629,383,299,270,60,252,610,41.3,358,355,95,260,392,1021,698,5,"https://fbref.com/en/squads/c539e393/2018-2019/Schalke-04-Stats"
2019,"Sevilla","La Liga","team",27,38,598,408,288,237,73,203,513,39.6,310,370,114,256,365,963,817,15,"https://fbref.com/en/squads/ad2be733/2018-2019/Sevilla-Stats"
2019,"Sevilla","La Liga","opponent",27,38,640,396,297,245,98,249,606,41.1,357,455,128,327,444,1084,994,15,"https://fbref.com/en/squads/ad2be733/2018-2019/Sevilla-Stats"
2019,"Southampton","Premier League","team",30,38,698,428,335,283,80,277,646,42.9,369,533,153,380,549,1247,1128,18,"https://fbref.com/en/squads/33c895d4/2018-2019/Southampton-Stats"
2019,"Southampton","Premier League","opponent",30,38,601,348,320,222,59,221,508,43.5,287,406,134,272,377,978,889,23,"https://fbref.com/en/squads/33c895d4/2018-2019/Southampton-Stats"
2019,"Strasbourg","Ligue 1","team",26,38,649,405,320,256,73,257,570,45.1,313,373,127,246,428,1077,751,12,"https://fbref.com/en/squads/c0d3eab4/2018-2019/Strasbourg-Stats"
2019,"Strasbourg","Ligue 1","opponent",26,38,628,387,308,245,75,229,515,44.5,286,401,93,308,390,1018,778,14,"https://fbref.com/en/squads/c0d3eab4/2018-2019/Strasbourg-Stats"
2019,"Stuttgart","Bundesliga","team",26,34,576,362,299,217,60,204,476,42.9,272,422,116,306,399,975,898,12,"https://fbref.com/en/squads/598bc722/2018-2019/Stuttgart-Stats"
2019,"Stuttgart","Bundesliga","opponent",26,34,466,282,229,193,44,158,397,39.8,239,376,99,277,358,824,747,13,"https://fbref.com/en/squads/598bc722/2018-2019/Stuttgart-Stats"
2019,"Torino","Serie A","team",25,38,636,394,272,283,81,226,506,44.7,280,462,117,345,451,1087,848,12,"https://fbref.com/en/squads/105360fe/2018-2019/Torino-Stats"
2019,"Torino","Serie A","opponent",25,38,701,438,346,271,84,251,589,42.6,338,418,116,302,373,1074,917,10,"https://fbref.com/en/squads/105360fe/2018-2019/Torino-Stats"
2019,"Tottenham","Premier League","team",28,38,627,373,310,237,80,268,577,46.4,309,415,112,303,325,952,823,20,"https://fbref.com/en/squads/361ca564/2018-2019/Tottenham-Hotspur-Stats"
2019,"Tottenham","Premier League","opponent",28,38,651,383,338,245,68,302,672,44.9,370,501,141,360,504,1155,937,33,"https://fbref.com/en/squads/361ca564/2018-2019/Tottenham-Hotspur-Stats"
2019,"Toulouse","Ligue 1","team",29,38,669,418,362,243,64,265,582,45.5,317,433,126,307,384,1053,947,17,"https://fbref.com/en/squads/3f8c4b5f/2018-2019/Toulouse-Stats"
2019,"Toulouse","Ligue 1","opponent",29,38,776,438,383,292,101,329,695,47.3,366,375,107,268,419,1195,800,17,"https://fbref.com/en/squads/3f8c4b5f/2018-2019/Toulouse-Stats"
2019,"Udinese","Serie A","team",31,38,651,387,341,250,60,245,554,44.2,309,450,161,289,381,1032,1065,15,"https://fbref.com/en/squads/04eea015/2018-2019/Udinese-Stats"
2019,"Udinese","Serie A","opponent",31,38,601,372,246,264,91,227,564,40.2,337,356,99,257,342,943,703,10,"https://fbref.com/en/squads/04eea015/2018-2019/Udinese-Stats"
2019,"Valencia","La Liga","team",25,38,598,384,299,228,71,238,588,40.5,350,447,120,327,418,1016,860,12,"https://fbref.com/en/squads/dcc91a7b/2018-2019/Valencia-Stats"
2019,"Valencia","La Liga","opponent",25,38,583,377,270,247,66,246,589,41.8,343,387,95,292,448,1031,818,16,"https://fbref.com/en/squads/dcc91a7b/2018-2019/Valencia-Stats"
2019,"Valladolid","La Liga","team",28,38,714,441,369,265,80,280,678,41.3,398,413,113,300,387,1101,874,16,"https://fbref.com/en/squads/17859612/2018-2019/Valladolid-Stats"
2019,"Valladolid","La Liga","opponent",28,38,530,347,260,216,54,183,477,38.4,294,358,87,271,395,925,825,12,"https://fbref.com/en/squads/17859612/2018-2019/Valladolid-Stats"
2019,"Villarreal","La Liga","team",26,38,667,413,333,255,79,273,659,41.4,386,406,142,264,390,1057,877,12,"https://fbref.com/en/squads/2a8183b3/2018-2019/Villarreal-Stats"
2019,"Villarreal","La Liga","opponent",26,38,595,359,319,205,71,255,603,42.3,348,403,129,274,439,1034,786,15,"https://fbref.com/en/squads/2a8183b3/2018-2019/Villarreal-Stats"
2019,"Watford","Premier League","team",25,38,656,391,350,243,63,257,622,41.3,365,404,120,284,428,1084,1022,18,"https://fbref.com/en/squads/2abfe087/2018-2019/Watford-Stats"
2019,"Watford","Premier League","opponent",25,38,669,392,328,255,86,251,543,46.2,292,418,125,293,451,1120,998,17,"https://fbref.com/en/squads/2abfe087/2018-2019/Watford-Stats"
2019,"Werder Bremen","Bundesliga","team",24,34,549,344,256,230,63,216,553,39.1,337,426,109,317,407,956,817,10,"https://fbref.com/en/squads/62add3bf/2018-2019/Werder-Bremen-Stats"
2019,"Werder Bremen","Bundesliga","opponent",24,34,525,324,279,204,42,193,413,46.7,220,465,111,354,416,941,770,14,"https://fbref.com/en/squads/62add3bf/2018-2019/Werder-Bremen-Stats"
2019,"West Ham","Premier League","team",26,38,723,393,385,279,59,295,697,42.3,402,488,142,346,457,1180,926,16,"https://fbref.com/en/squads/7c21e445/2018-2019/West-Ham-United-Stats"
2019,"West Ham","Premier League","opponent",26,38,669,414,307,290,72,279,668,41.8,389,457,115,342,409,1078,807,16,"https://fbref.com/en/squads/7c21e445/2018-2019/West-Ham-United-Stats"
2019,"Wolfsburg","Bundesliga","team",25,34,542,343,272,209,61,219,505,43.4,286,399,95,304,426,968,791,18,"https://fbref.com/en/squads/4eaa11d7/2018-2019/Wolfsburg-Stats"
2019,"Wolfsburg","Bundesliga","opponent",25,34,510,321,250,197,63,180,436,41.3,256,420,100,320,393,903,795,10,"https://fbref.com/en/squads/4eaa11d7/2018-2019/Wolfsburg-Stats"
2019,"Wolves","Premier League","team",21,38,720,408,385,284,51,283,664,42.6,381,499,148,351,501,1221,895,23,"https://fbref.com/en/squads/8cec06e1/2018-2019/Wolverhampton-Wanderers-Stats"
2019,"Wolves","Premier League","opponent",21,38,666,410,304,295,67,264,595,44.4,331,437,119,318,387,1053,828,24,"https://fbref.com/en/squads/8cec06e1/2018-2019/Wolverhampton-Wanderers-Stats"
2020,"Alavés","La Liga","team",32,38,579,346,261,265,53,255,619,41.2,364,385,114,271,392,971,766,7,"https://fbref.com/en/squads/8d6fd021/2019-2020/Alaves-Stats"
2020,"Alavés","La Liga","opponent",32,38,555,347,228,258,69,246,497,49.5,251,291,66,225,329,884,584,10,"https://fbref.com/en/squads/8d6fd021/2019-2020/Alaves-Stats"
2020,"Amiens","Ligue 1","team",27,28,425,238,194,184,47,201,510,39.4,309,280,87,193,300,725,615,17,"https://fbref.com/en/squads/25622401/2019-2020/Amiens-Stats"
2020,"Amiens","Ligue 1","opponent",27,28,523,326,224,249,50,165,409,40.3,244,240,54,186,338,861,459,8,"https://fbref.com/en/squads/25622401/2019-2020/Amiens-Stats"
2020,"Angers","Ligue 1","team",26,28,439,279,206,178,55,177,452,39.2,275,229,51,178,267,706,513,8,"https://fbref.com/en/squads/69236f98/2019-2020/Angers-Stats"
2020,"Angers","Ligue 1","opponent",26,28,531,320,274,204,53,187,478,39.1,291,278,88,190,301,832,543,7,"https://fbref.com/en/squads/69236f98/2019-2020/Angers-Stats"
2020,"Arsenal","Premier League","team",29,38,584,336,296,217,71,249,612,40.7,363,398,141,257,351,935,754,18,"https://fbref.com/en/squads/18bb7c10/2019-2020/Arsenal-Stats"
2020,"Arsenal","Premier League","opponent",29,38,656,388,317,242,97,286,697,41,411,354,100,254,425,1081,722,19,"https://fbref.com/en/squads/18bb7c10/2019-2020/Arsenal-Stats"
2020,"Aston Villa","Premier League","team",28,38,523,291,285,174,64,223,597,37.4,374,456,184,272,423,946,928,26,"https://fbref.com/en/squads/8602292d/2019-2020/Aston-Villa-Stats"
2020,"Aston Villa","Premier League","opponent",28,38,530,315,248,206,76,217,569,38.1,352,353,115,238,346,876,785,14,"https://fbref.com/en/squads/8602292d/2019-2020/Aston-Villa-Stats"
2020,"Atalanta","Serie A","team",30,38,627,351,252,278,97,263,643,40.9,380,396,111,285,418,1045,532,12,"https://fbref.com/en/squads/922493f3/2019-2020/Atalanta-Stats"
2020,"Atalanta","Serie A","opponent",30,38,627,351,353,232,42,268,615,43.6,347,455,171,284,439,1066,778,15,"https://fbref.com/en/squads/922493f3/2019-2020/Atalanta-Stats"
2020,"Athletic Club","La Liga","team",26,38,533,324,262,204,67,217,613,35.4,396,339,92,247,373,906,755,7,"https://fbref.com/en/squads/2b390eca/2019-2020/Athletic-Club-Stats"
2020,"Athletic Club","La Liga","opponent",26,38,549,313,270,222,57,250,587,42.6,337,330,85,245,327,876,704,15,"https://fbref.com/en/squads/2b390eca/2019-2020/Athletic-Club-Stats"
2020,"Atlético Madrid","La Liga","team",30,38,658,406,293,272,93,283,640,44.2,357,380,108,272,412,1070,729,18,"https://fbref.com/en/squads/db3b9613/2019-2020/Atletico-Madrid-Stats"
2020,"Atlético Madrid","La Liga","opponent",30,38,572,355,292,224,56,195,543,35.9,348,342,112,230,384,956,709,12,"https://fbref.com/en/squads/db3b9613/2019-2020/Atletico-Madrid-Stats"
2020,"Augsburg","Bundesliga","team",28,34,534,314,271,215,48,220,563,39.1,343,362,123,239,434,968,778,8,"https://fbref.com/en/squads/0cdc4311/2019-2020/Augsburg-Stats"
2020,"Augsburg","Bundesliga","opponent",28,34,544,329,263,196,85,240,473,50.7,233,348,70,278,312,856,492,11,"https://fbref.com/en/squads/0cdc4311/2019-2020/Augsburg-Stats"
2020,"Barcelona","La Liga","team",28,38,536,323,216,223,97,211,501,42.1,290,313,87,226,342,878,529,16,"https://fbref.com/en/squads/206d90db/2019-2020/Barcelona-Stats"
2020,"Barcelona","La Liga","opponent",28,38,623,361,351,202,70,269,793,33.9,524,430,117,313,525,1148,575,12,"https://fbref.com/en/squads/206d90db/2019-2020/Barcelona-Stats"
2020,"Bayern Munich","Bundesliga","team",29,34,500,293,180,222,98,211,503,41.9,292,290,79,211,342,842,382,9,"https://fbref.com/en/squads/054efa67/2019-2020/Bayern-Munich-Stats"
2020,"Bayern Munich","Bundesliga","opponent",29,34,570,351,322,193,55,261,741,35.2,480,424,126,298,468,1038,867,14,"https://fbref.com/en/squads/054efa67/2019-2020/Bayern-Munich-Stats"
2020,"Betis","La Liga","team",27,38,501,299,276,173,52,221,511,43.2,290,336,119,217,302,803,682,8,"https://fbref.com/en/squads/fc536746/2019-2020/Real-Betis-Stats"
2020,"Betis","La Liga","opponent",27,38,623,374,301,251,71,268,713,37.6,445,369,108,261,364,987,644,13,"https://fbref.com/en/squads/fc536746/2019-2020/Real-Betis-Stats"
2020,"Bologna","Serie A","team",31,38,575,338,270,238,67,226,619,36.5,393,390,125,265,412,987,667,13,"https://fbref.com/en/squads/1d8099f8/2019-2020/Bologna-Stats"
2020,"Bologna","Serie A","opponent",31,38,609,354,320,232,57,278,627,44.3,349,408,151,257,392,1001,742,13,"https://fbref.com/en/squads/1d8099f8/2019-2020/Bologna-Stats"
2020,"Bordeaux","Ligue 1","team",26,28,483,284,232,206,45,230,595,38.7,365,237,89,148,302,785,575,13,"https://fbref.com/en/squads/123f3efe/2019-2020/Bordeaux-Stats"
2020,"Bordeaux","Ligue 1","opponent",26,28,518,316,207,247,64,233,506,46,273,233,65,168,308,826,434,15,"https://fbref.com/en/squads/123f3efe/2019-2020/Bordeaux-Stats"
2020,"Bournemouth","Premier League","team",27,38,507,299,254,206,47,207,567,36.5,360,439,160,279,475,982,1008,16,"https://fbref.com/en/squads/4ba7cbea/2019-2020/Bournemouth-Stats"
2020,"Bournemouth","Premier League","opponent",27,38,661,389,299,265,97,277,602,46,325,443,117,326,402,1063,824,15,"https://fbref.com/en/squads/4ba7cbea/2019-2020/Bournemouth-Stats"
2020,"Brescia","Serie A","team",32,38,507,273,256,195,56,226,559,40.4,333,399,170,229,361,868,886,12,"https://fbref.com/en/squads/4ef57aeb/2019-2020/Brescia-Stats"
2020,"Brescia","Serie A","opponent",32,38,491,274,211,208,72,175,450,38.9,275,374,95,279,376,867,654,14,"https://fbref.com/en/squads/4ef57aeb/2019-2020/Brescia-Stats"
2020,"Brest","Ligue 1","team",24,28,484,282,238,186,60,184,472,39,288,263,82,181,352,836,537,11,"https://fbref.com/en/squads/fb08dbb3/2019-2020/Brest-Stats"
2020,"Brest","Ligue 1","opponent",24,28,438,284,175,202,61,155,364,42.6,209,278,71,207,330,768,557,13,"https://fbref.com/en/squads/fb08dbb3/2019-2020/Brest-Stats"
2020,"Brighton","Premier League","team",25,38,641,379,295,269,77,245,642,38.2,397,437,137,300,419,1060,750,15,"https://fbref.com/en/squads/d07537b9/2019-2020/Brighton-and-Hove-Albion-Stats"
2020,"Brighton","Premier League","opponent",25,38,648,385,329,250,69,249,584,42.6,335,426,126,300,428,1076,748,16,"https://fbref.com/en/squads/d07537b9/2019-2020/Brighton-and-Hove-Albion-Stats"
2020,"Burnley","Premier League","team",22,38,547,344,238,241,68,240,585,41,345,450,175,275,387,934,901,15,"https://fbref.com/en/squads/943e8050/2019-2020/Burnley-Stats"
2020,"Burnley","Premier League","opponent",22,38,499,319,235,219,45,208,454,45.8,246,285,91,194,293,792,841,20,"https://fbref.com/en/squads/943e8050/2019-2020/Burnley-Stats"
2020,"Cagliari","Serie A","team",33,38,560,338,300,203,57,231,619,37.3,388,445,174,271,337,897,855,13,"https://fbref.com/en/squads/c4260e09/2019-2020/Cagliari-Stats"
2020,"Cagliari","Serie A","opponent",33,38,551,305,238,238,75,214,538,39.8,324,322,94,228,372,923,728,4,"https://fbref.com/en/squads/c4260e09/2019-2020/Cagliari-Stats"
2020,"Celta Vigo","La Liga","team",30,38,589,357,344,193,52,251,615,40.8,364,345,89,256,396,985,807,12,"https://fbref.com/en/squads/f25da7fb/2019-2020/Celta-Vigo-Stats"
2020,"Celta Vigo","La Liga","opponent",30,38,615,348,253,275,87,240,610,39.3,370,401,88,313,384,999,646,14,"https://fbref.com/en/squads/f25da7fb/2019-2020/Celta-Vigo-Stats"
2020,"Chelsea","Premier League","team",27,38,638,362,304,258,76,246,604,40.7,358,361,91,270,459,1097,631,14,"https://fbref.com/en/squads/cff3d9bb/2019-2020/Chelsea-Stats"
2020,"Chelsea","Premier League","opponent",27,38,672,381,325,269,78,258,718,35.9,460,471,179,292,434,1106,950,20,"https://fbref.com/en/squads/cff3d9bb/2019-2020/Chelsea-Stats"
2020,"Crystal Palace","Premier League","team",25,38,686,390,367,244,75,316,711,44.4,395,399,135,264,444,1130,856,18,"https://fbref.com/en/squads/47c64c55/2019-2020/Crystal-Palace-Stats"
2020,"Crystal Palace","Premier League","opponent",25,38,745,425,383,287,75,266,698,38.1,432,370,100,270,449,1194,712,14,"https://fbref.com/en/squads/47c64c55/2019-2020/Crystal-Palace-Stats"
2020,"Dijon","Ligue 1","team",28,28,516,304,259,208,49,239,548,43.6,309,277,100,177,332,848,596,14,"https://fbref.com/en/squads/8dfb7350/2019-2020/Dijon-Stats"
2020,"Dijon","Ligue 1","opponent",28,28,534,322,216,256,62,231,543,42.5,312,257,79,178,333,867,485,5,"https://fbref.com/en/squads/8dfb7350/2019-2020/Dijon-Stats"
2020,"Dortmund","Bundesliga","team",27,34,529,329,249,214,66,226,509,44.4,283,353,88,265,375,904,463,10,"https://fbref.com/en/squads/add600ae/2019-2020/Dortmund-Stats"
2020,"Dortmund","Bundesliga","opponent",27,34,633,381,312,240,81,282,750,37.6,468,405,94,311,449,1082,569,12,"https://fbref.com/en/squads/add600ae/2019-2020/Dortmund-Stats"
2020,"Düsseldorf","Bundesliga","team",28,34,496,307,244,199,53,200,540,37,340,350,105,245,376,872,610,9,"https://fbref.com/en/squads/b1278397/2019-2020/Dusseldorf-Stats"
2020,"Düsseldorf","Bundesliga","opponent",28,34,468,291,229,183,56,196,453,43.3,257,341,121,220,323,791,708,11,"https://fbref.com/en/squads/b1278397/2019-2020/Dusseldorf-Stats"
2020,"Eibar","La Liga","team",26,38,567,338,240,228,99,264,607,43.5,343,332,81,251,430,997,692,8,"https://fbref.com/en/squads/bea5c710/2019-2020/Eibar-Stats"
2020,"Eibar","La Liga","opponent",26,38,553,331,293,218,42,198,458,43.2,260,328,97,231,342,895,923,17,"https://fbref.com/en/squads/bea5c710/2019-2020/Eibar-Stats"
2020,"Eint Frankfurt","Bundesliga","team",27,34,596,377,278,246,72,232,617,37.6,385,403,97,306,376,972,520,5,"https://fbref.com/en/squads/f0ac8ee6/2019-2020/Eintracht-Frankfurt-Stats"
2020,"Eint Frankfurt","Bundesliga","opponent",27,34,491,293,266,193,32,190,520,36.5,330,417,114,303,403,894,780,5,"https://fbref.com/en/squads/f0ac8ee6/2019-2020/Eintracht-Frankfurt-Stats"
2020,"Espanyol","La Liga","team",31,38,628,364,303,253,72,257,701,36.7,444,380,96,284,360,988,731,17,"https://fbref.com/en/squads/a8661628/2019-2020/Espanyol-Stats"
2020,"Espanyol","La Liga","opponent",31,38,539,304,265,217,57,208,489,42.5,281,319,107,212,367,906,787,9,"https://fbref.com/en/squads/a8661628/2019-2020/Espanyol-Stats"
2020,"Everton","Premier League","team",24,38,671,408,328,262,81,282,672,42,390,372,111,261,408,1079,778,13,"https://fbref.com/en/squads/d3fd31cc/2019-2020/Everton-Stats"
2020,"Everton","Premier League","opponent",24,38,580,358,273,238,69,235,609,38.6,374,415,127,288,383,963,846,13,"https://fbref.com/en/squads/d3fd31cc/2019-2020/Everton-Stats"
2020,"Fiorentina","Serie A","team",33,38,571,333,300,205,66,213,628,33.9,415,346,98,248,347,918,719,9,"https://fbref.com/en/squads/421387cf/2019-2020/Fiorentina-Stats"
2020,"Fiorentina","Serie A","opponent",33,38,630,367,282,257,91,242,670,36.1,428,379,136,243,369,999,676,12,"https://fbref.com/en/squads/421387cf/2019-2020/Fiorentina-Stats"
2020,"Freiburg","Bundesliga","team",26,34,431,252,226,162,43,175,497,35.2,322,401,157,244,354,785,810,18,"https://fbref.com/en/squads/a486e511/2019-2020/Freiburg-Stats"
2020,"Freiburg","Bundesliga","opponent",26,34,462,303,224,181,57,203,452,44.9,249,403,116,287,304,766,656,11,"https://fbref.com/en/squads/a486e511/2019-2020/Freiburg-Stats"
2020,"Genoa","Serie A","team",34,38,551,335,268,210,73,212,589,36,377,410,150,260,385,936,775,16,"https://fbref.com/en/squads/658bf2de/2019-2020/Genoa-Stats"
2020,"Genoa","Serie A","opponent",34,38,579,322,293,203,83,230,565,40.7,335,369,103,266,365,944,722,13,"https://fbref.com/en/squads/658bf2de/2019-2020/Genoa-Stats"
2020,"Getafe","La Liga","team",30,38,580,341,235,263,82,235,573,41,338,374,60,314,367,947,625,12,"https://fbref.com/en/squads/7848bd64/2019-2020/Getafe-Stats"
2020,"Getafe","La Liga","opponent",30,38,520,292,307,174,39,202,476,42.4,274,384,100,284,384,904,852,13,"https://fbref.com/en/squads/7848bd64/2019-2020/Getafe-Stats"
2020,"Granada","La Liga","team",27,38,584,349,257,257,70,238,570,41.8,332,375,118,257,383,967,750,10,"https://fbref.com/en/squads/a0435291/2019-2020/Granada-Stats"
2020,"Granada","La Liga","opponent",27,38,543,302,267,206,70,253,553,45.8,300,335,99,236,333,876,665,13,"https://fbref.com/en/squads/a0435291/2019-2020/Granada-Stats"
2020,"Hellas Verona","Serie A","team",30,38,488,290,237,187,64,203,463,43.8,260,361,173,188,398,886,825,10,"https://fbref.com/en/squads/0e72edf2/2019-2020/Hellas-Verona-Stats"
2020,"Hellas Verona","Serie A","opponent",30,38,525,308,244,209,72,218,546,39.9,328,368,111,257,358,883,693,13,"https://fbref.com/en/squads/0e72edf2/2019-2020/Hellas-Verona-Stats"
2020,"Hertha BSC","Bundesliga","team",32,34,555,340,282,221,52,208,521,39.9,313,434,130,304,410,965,794,12,"https://fbref.com/en/squads/2818f8bc/2019-2020/Hertha-BSC-Stats"
2020,"Hertha BSC","Bundesliga","opponent",32,34,523,320,243,224,56,175,526,33.3,351,331,74,257,289,812,515,7,"https://fbref.com/en/squads/2818f8bc/2019-2020/Hertha-BSC-Stats"
2020,"Hoffenheim","Bundesliga","team",31,34,529,309,283,196,50,239,578,41.3,339,384,121,263,349,878,719,9,"https://fbref.com/en/squads/033ea6b8/2019-2020/Hoffenheim-Stats"
2020,"Hoffenheim","Bundesliga","opponent",31,34,537,315,242,225,70,213,512,41.6,299,397,104,293,336,873,595,15,"https://fbref.com/en/squads/033ea6b8/2019-2020/Hoffenheim-Stats"
2020,"Inter","Serie A","team",29,38,524,287,228,212,84,196,575,34.1,379,371,120,251,370,894,657,12,"https://fbref.com/en/squads/d609edc0/2019-2020/Internazionale-Stats"
2020,"Inter","Serie A","opponent",29,38,479,269,239,183,57,187,498,37.6,311,416,163,253,469,948,840,19,"https://fbref.com/en/squads/d609edc0/2019-2020/Internazionale-Stats"
2020,"Juventus","Serie A","team",30,38,539,318,225,219,95,224,582,38.5,358,374,120,254,370,909,590,14,"https://fbref.com/en/squads/e0652b02/2019-2020/Juventus-Stats"
2020,"Juventus","Serie A","opponent",30,38,548,312,290,192,66,255,689,37,434,413,175,238,429,977,676,15,"https://fbref.com/en/squads/e0652b02/2019-2020/Juventus-Stats"
2020,"Köln","Bundesliga","team",29,34,610,414,293,258,59,249,622,40,373,397,97,300,435,1045,681,5,"https://fbref.com/en/squads/bc357bf7/2019-2020/Koln-Stats"
2020,"Köln","Bundesliga","opponent",29,34,477,298,196,211,70,178,450,39.6,272,340,94,246,387,864,686,11,"https://fbref.com/en/squads/bc357bf7/2019-2020/Koln-Stats"
2020,"Lazio","Serie A","team",27,38,547,311,270,205,72,224,612,36.6,388,404,142,262,378,925,642,9,"https://fbref.com/en/squads/7213da33/2019-2020/Lazio-Stats"
2020,"Lazio","Serie A","opponent",27,38,488,280,237,182,69,218,578,37.7,360,400,127,273,434,922,750,10,"https://fbref.com/en/squads/7213da33/2019-2020/Lazio-Stats"
2020,"Lecce","Serie A","team",30,38,525,293,288,192,45,234,628,37.3,394,395,150,245,383,908,793,30,"https://fbref.com/en/squads/ffcbe334/2019-2020/Lecce-Stats"
2020,"Lecce","Serie A","opponent",30,38,486,294,206,210,70,168,464,36.2,296,388,120,268,343,829,651,11,"https://fbref.com/en/squads/ffcbe334/2019-2020/Lecce-Stats"
2020,"Leganés","La Liga","team",29,38,603,357,317,215,71,254,610,41.6,356,320,73,247,418,1021,687,7,"https://fbref.com/en/squads/7c6f2c78/2019-2020/Leganes-Stats"
2020,"Leganés","La Liga","opponent",29,38,530,339,260,214,56,239,581,41.1,342,324,100,224,332,862,850,6,"https://fbref.com/en/squads/7c6f2c78/2019-2020/Leganes-Stats"
2020,"Leicester City","Premier League","team",24,38,742,432,347,320,75,298,725,41.1,427,420,92,328,423,1165,767,16,"https://fbref.com/en/squads/a2d435b3/2019-2020/Leicester-City-Stats"
2020,"Leicester City","Premier League","opponent",24,38,639,402,299,255,85,311,688,45.2,377,416,137,279,432,1071,836,17,"https://fbref.com/en/squads/a2d435b3/2019-2020/Leicester-City-Stats"
2020,"Levante","La Liga","team",29,38,507,288,281,173,53,204,532,38.3,328,317,107,210,331,838,763,14,"https://fbref.com/en/squads/9800b6a1/2019-2020/Levante-Stats"
2020,"Levante","La Liga","opponent",29,38,553,349,242,226,85,251,637,39.4,386,385,112,273,323,876,662,7,"https://fbref.com/en/squads/9800b6a1/2019-2020/Levante-Stats"
2020,"Leverkusen","Bundesliga","team",24,34,557,353,239,244,74,263,600,43.8,337,365,71,294,333,890,496,11,"https://fbref.com/en/squads/c7a9f859/2019-2020/Bayer-Leverkusen-Stats"
2020,"Leverkusen","Bundesliga","opponent",24,34,620,370,275,284,61,260,710,36.6,450,438,132,306,478,1098,742,13,"https://fbref.com/en/squads/c7a9f859/2019-2020/Bayer-Leverkusen-Stats"
2020,"Lille","Ligue 1","team",25,28,424,237,163,203,58,183,467,39.2,284,263,62,201,278,702,450,9,"https://fbref.com/en/squads/cb188c0c/2019-2020/Lille-Stats"
2020,"Lille","Ligue 1","opponent",25,28,515,298,295,179,41,215,522,41.2,307,274,73,201,284,799,585,18,"https://fbref.com/en/squads/cb188c0c/2019-2020/Lille-Stats"
2020,"Liverpool","Premier League","team",24,38,550,325,195,243,112,217,588,36.9,371,302,68,234,352,902,634,25,"https://fbref.com/en/squads/822bd0ba/2019-2020/Liverpool-Stats"
2020,"Liverpool","Premier League","opponent",24,38,577,346,345,190,42,271,658,41.2,387,437,159,278,456,1033,1147,33,"https://fbref.com/en/squads/822bd0ba/2019-2020/Liverpool-Stats"
2020,"Lyon","Ligue 1","team",27,28,492,304,232,193,67,201,442,45.5,241,241,94,147,311,803,540,7,"https://fbref.com/en/squads/d53c0b06/2019-2020/Lyon-Stats"
2020,"Lyon","Ligue 1","opponent",27,28,530,303,266,222,42,237,578,41,341,251,71,180,315,845,543,11,"https://fbref.com/en/squads/d53c0b06/2019-2020/Lyon-Stats"
2020,"M'Gladbach","Bundesliga","team",25,34,552,322,254,215,83,228,586,38.9,358,398,106,292,381,933,596,11,"https://fbref.com/en/squads/32f3ee20/2019-2020/Monchengladbach-Stats"
2020,"M'Gladbach","Bundesliga","opponent",25,34,572,350,273,235,64,251,638,39.3,387,395,122,273,440,1012,579,17,"https://fbref.com/en/squads/32f3ee20/2019-2020/Monchengladbach-Stats"
2020,"Mainz 05","Bundesliga","team",25,34,576,331,280,233,63,225,542,41.5,317,403,110,293,363,939,724,13,"https://fbref.com/en/squads/a224b06a/2019-2020/Mainz-05-Stats"
2020,"Mainz 05","Bundesliga","opponent",25,34,581,345,291,205,85,235,614,38.3,379,337,120,217,345,926,705,5,"https://fbref.com/en/squads/a224b06a/2019-2020/Mainz-05-Stats"
2020,"Mallorca","La Liga","team",32,38,545,338,280,213,52,227,602,37.7,375,360,117,243,376,921,672,9,"https://fbref.com/en/squads/2aa12281/2019-2020/Mallorca-Stats"
2020,"Mallorca","La Liga","opponent",32,38,670,393,315,277,78,317,709,44.7,392,352,94,258,383,1053,690,8,"https://fbref.com/en/squads/2aa12281/2019-2020/Mallorca-Stats"
2020,"Manchester City","Premier League","team",24,38,514,301,204,210,100,230,605,38,375,292,66,226,352,866,495,21,"https://fbref.com/en/squads/b8fd03ef/2019-2020/Manchester-City-Stats"
2020,"Manchester City","Premier League","opponent",24,38,575,337,360,173,42,234,721,32.5,487,468,220,248,477,1052,1000,24,"https://fbref.com/en/squads/b8fd03ef/2019-2020/Manchester-City-Stats"
2020,"Manchester Utd","Premier League","team",29,38,579,333,267,231,81,254,634,40.1,380,360,99,261,379,958,703,14,"https://fbref.com/en/squads/19538871/2019-2020/Manchester-United-Stats"
2020,"Manchester Utd","Premier League","opponent",29,38,697,385,348,272,77,301,747,40.3,446,444,124,320,485,1182,721,21,"https://fbref.com/en/squads/19538871/2019-2020/Manchester-United-Stats"
2020,"Marseille","Ligue 1","team",23,28,564,325,246,246,72,235,560,42,325,264,58,206,312,876,533,9,"https://fbref.com/en/squads/5725cc7b/2019-2020/Marseille-Stats"
2020,"Marseille","Ligue 1","opponent",23,28,492,289,234,204,54,194,510,38,316,248,89,159,321,813,522,10,"https://fbref.com/en/squads/5725cc7b/2019-2020/Marseille-Stats"
2020,"Metz","Ligue 1","team",24,28,526,337,295,186,45,213,475,44.8,262,293,97,196,312,838,635,5,"https://fbref.com/en/squads/f83960ae/2019-2020/Metz-Stats"
2020,"Metz","Ligue 1","opponent",24,28,526,319,235,238,53,224,561,39.9,337,224,67,157,285,811,462,5,"https://fbref.com/en/squads/f83960ae/2019-2020/Metz-Stats"
2020,"Milan","Serie A","team",32,38,581,345,270,237,74,234,620,37.7,386,353,106,247,419,1000,652,19,"https://fbref.com/en/squads/dc56fe14/2019-2020/Milan-Stats"
2020,"Milan","Serie A","opponent",32,38,596,349,294,212,90,254,656,38.7,402,420,173,247,409,1005,785,17,"https://fbref.com/en/squads/dc56fe14/2019-2020/Milan-Stats"
2020,"Monaco","Ligue 1","team",28,28,504,307,231,221,52,235,556,42.3,321,249,70,179,281,785,495,15,"https://fbref.com/en/squads/fd6114db/2019-2020/Monaco-Stats"
2020,"Monaco","Ligue 1","opponent",28,28,451,260,204,200,47,192,500,38.4,308,284,91,193,329,780,535,17,"https://fbref.com/en/squads/fd6114db/2019-2020/Monaco-Stats"
2020,"Montpellier","Ligue 1","team",27,28,449,286,215,190,44,217,570,38.1,353,220,83,137,308,757,520,7,"https://fbref.com/en/squads/281b0e73/2019-2020/Montpellier-Stats"
2020,"Montpellier","Ligue 1","opponent",27,28,423,236,207,166,50,231,449,51.4,218,270,72,198,297,720,596,6,"https://fbref.com/en/squads/281b0e73/2019-2020/Montpellier-Stats"
2020,"Nantes","Ligue 1","team",29,28,548,347,245,249,54,265,550,48.2,285,217,72,145,305,853,512,4,"https://fbref.com/en/squads/d7a486cd/2019-2020/Nantes-Stats"
2020,"Nantes","Ligue 1","opponent",29,28,543,343,277,216,50,238,560,42.5,322,279,81,198,312,855,485,15,"https://fbref.com/en/squads/d7a486cd/2019-2020/Nantes-Stats"
2020,"Napoli","Serie A","team",25,38,487,295,223,183,81,206,540,38.1,334,322,86,236,330,817,464,11,"https://fbref.com/en/squads/d48ad4ff/2019-2020/Napoli-Stats"
2020,"Napoli","Serie A","opponent",25,38,521,306,280,175,66,225,587,38.3,362,434,163,271,415,936,812,12,"https://fbref.com/en/squads/d48ad4ff/2019-2020/Napoli-Stats"
2020,"Newcastle Utd","Premier League","team",28,38,603,357,364,198,41,273,632,43.2,359,402,152,250,391,994,988,19,"https://fbref.com/en/squads/b2b47a98/2019-2020/Newcastle-United-Stats"
2020,"Newcastle Utd","Premier League","opponent",28,38,562,334,248,239,75,274,674,40.7,400,365,114,251,341,903,616,7,"https://fbref.com/en/squads/b2b47a98/2019-2020/Newcastle-United-Stats"
2020,"Nice","Ligue 1","team",31,28,471,279,246,180,45,212,516,41.1,304,280,81,199,343,814,480,13,"https://fbref.com/en/squads/132ebc33/2019-2020/Nice-Stats"
2020,"Nice","Ligue 1","opponent",31,28,543,327,259,217,67,262,626,41.9,364,253,88,165,332,875,404,5,"https://fbref.com/en/squads/132ebc33/2019-2020/Nice-Stats"
2020,"Norwich City","Premier League","team",30,38,628,379,359,210,59,267,700,38.1,433,453,171,282,397,1025,959,20,"https://fbref.com/en/squads/1c781004/2019-2020/Norwich-City-Stats"
2020,"Norwich City","Premier League","opponent",30,38,684,400,291,275,118,278,705,39.4,427,444,120,324,430,1114,602,13,"https://fbref.com/en/squads/1c781004/2019-2020/Norwich-City-Stats"
2020,"Nîmes","Ligue 1","team",28,28,552,302,235,258,59,249,599,41.6,350,272,75,197,329,881,469,6,"https://fbref.com/en/squads/1cbf5f9e/2019-2020/Nimes-Stats"
2020,"Nîmes","Ligue 1","opponent",28,28,486,329,261,191,34,236,469,50.3,233,257,84,173,257,743,605,7,"https://fbref.com/en/squads/1cbf5f9e/2019-2020/Nimes-Stats"
2020,"Osasuna","La Liga","team",31,38,613,361,275,267,71,267,617,43.3,350,385,98,287,417,1030,738,19,"https://fbref.com/en/squads/03c57e2b/2019-2020/Osasuna-Stats"
2020,"Osasuna","La Liga","opponent",31,38,516,316,234,218,64,210,525,40,315,345,91,254,406,922,776,18,"https://fbref.com/en/squads/03c57e2b/2019-2020/Osasuna-Stats"
2020,"Paderborn 07","Bundesliga","team",27,34,632,400,354,221,57,301,722,41.7,421,435,111,324,364,996,747,9,"https://fbref.com/en/squads/d9f93f02/2019-2020/Paderborn-07-Stats"
2020,"Paderborn 07","Bundesliga","opponent",27,34,669,413,319,270,80,307,689,44.6,382,457,116,341,393,1062,646,8,"https://fbref.com/en/squads/d9f93f02/2019-2020/Paderborn-07-Stats"
2020,"Paris S-G","Ligue 1","team",31,27,484,295,191,220,73,191,473,40.4,282,258,57,201,255,739,303,13,"https://fbref.com/en/squads/e2d8892c/2019-2020/Paris-Saint-Germain-Stats"
2020,"Paris S-G","Ligue 1","opponent",31,27,501,305,252,184,65,268,674,39.8,406,233,80,153,296,797,559,14,"https://fbref.com/en/squads/e2d8892c/2019-2020/Paris-Saint-Germain-Stats"
2020,"Parma","Serie A","team",25,38,615,348,329,228,58,282,708,39.8,426,423,177,246,394,1009,859,14,"https://fbref.com/en/squads/eab4234c/2019-2020/Parma-Stats"
2020,"Parma","Serie A","opponent",25,38,593,341,280,231,82,237,563,42.1,326,335,102,233,411,1004,606,13,"https://fbref.com/en/squads/eab4234c/2019-2020/Parma-Stats"
2020,"RB Leipzig","Bundesliga","team",29,34,616,361,280,251,85,258,624,41.3,366,397,86,311,364,980,610,16,"https://fbref.com/en/squads/acbb6a5b/2019-2020/RB-Leipzig-Stats"
2020,"RB Leipzig","Bundesliga","opponent",29,34,555,312,264,227,64,235,623,37.7,388,429,120,309,467,1022,626,17,"https://fbref.com/en/squads/acbb6a5b/2019-2020/RB-Leipzig-Stats"
2020,"Real Madrid","La Liga","team",26,38,586,355,252,253,81,226,595,38,369,367,77,290,381,967,590,13,"https://fbref.com/en/squads/53a2f082/2019-2020/Real-Madrid-Stats"
2020,"Real Madrid","La Liga","opponent",26,38,600,352,302,216,82,285,769,37.1,484,367,101,266,374,974,777,14,"https://fbref.com/en/squads/53a2f082/2019-2020/Real-Madrid-Stats"
2020,"Real Sociedad","La Liga","team",27,38,551,321,254,224,73,252,573,44,321,346,79,267,320,871,694,12,"https://fbref.com/en/squads/e31d1cd9/2019-2020/Real-Sociedad-Stats"
2020,"Real Sociedad","La Liga","opponent",27,38,591,359,268,260,63,234,589,39.7,355,421,108,313,409,1000,708,9,"https://fbref.com/en/squads/e31d1cd9/2019-2020/Real-Sociedad-Stats"
2020,"Reims","Ligue 1","team",26,28,490,324,259,185,46,184,401,45.9,217,228,72,156,325,815,514,8,"https://fbref.com/en/squads/7fdd64e0/2019-2020/Reims-Stats"
2020,"Reims","Ligue 1","opponent",26,28,449,266,203,189,57,218,519,42,301,263,83,180,272,721,547,9,"https://fbref.com/en/squads/7fdd64e0/2019-2020/Reims-Stats"
2020,"Rennes","Ligue 1","team",26,28,501,296,251,205,45,218,533,40.9,315,277,96,181,272,773,594,7,"https://fbref.com/en/squads/b3072e00/2019-2020/Rennes-Stats"
2020,"Rennes","Ligue 1","opponent",26,28,490,300,230,208,52,227,488,46.5,261,257,77,180,325,815,460,10,"https://fbref.com/en/squads/b3072e00/2019-2020/Rennes-Stats"
2020,"Roma","Serie A","team",31,38,493,303,202,203,88,197,503,39.2,306,347,107,240,400,893,644,15,"https://fbref.com/en/squads/cf74a709/2019-2020/Roma-Stats"
2020,"Roma","Serie A","opponent",31,38,534,328,280,192,62,253,670,37.8,417,383,183,200,368,902,804,17,"https://fbref.com/en/squads/cf74a709/2019-2020/Roma-Stats"
2020,"SPAL","Serie A","team",34,38,554,327,299,197,58,222,571,38.9,349,390,170,220,394,948,748,15,"https://fbref.com/en/squads/1d2fe027/2019-2020/SPAL-Stats"
2020,"SPAL","Serie A","opponent",34,38,516,320,238,210,68,161,518,31.1,357,384,122,262,311,827,645,7,"https://fbref.com/en/squads/1d2fe027/2019-2020/SPAL-Stats"
2020,"Saint-Étienne","Ligue 1","team",31,28,512,318,212,238,62,219,508,43.1,289,267,63,204,376,888,478,15,"https://fbref.com/en/squads/d298ef2c/2019-2020/Saint-Etienne-Stats"
2020,"Saint-Étienne","Ligue 1","opponent",31,28,491,306,225,211,55,196,485,40.4,289,235,64,171,370,861,559,12,"https://fbref.com/en/squads/d298ef2c/2019-2020/Saint-Etienne-Stats"
2020,"Sampdoria","Serie A","team",31,38,584,354,267,224,93,230,605,38,375,397,116,281,396,980,778,5,"https://fbref.com/en/squads/8ff9e3b3/2019-2020/Sampdoria-Stats"
2020,"Sampdoria","Serie A","opponent",31,38,495,281,225,219,51,200,507,39.4,307,391,147,244,370,865,789,19,"https://fbref.com/en/squads/8ff9e3b3/2019-2020/Sampdoria-Stats"
2020,"Sassuolo","Serie A","team",31,38,553,332,273,211,69,249,556,44.8,307,392,130,262,348,901,666,9,"https://fbref.com/en/squads/e2befd26/2019-2020/Sassuolo-Stats"
2020,"Sassuolo","Serie A","opponent",31,38,628,377,320,226,82,288,756,38.1,468,412,164,248,411,1039,654,15,"https://fbref.com/en/squads/e2befd26/2019-2020/Sassuolo-Stats"
2020,"Schalke 04","Bundesliga","team",29,34,589,361,268,242,79,255,625,40.8,370,474,118,356,407,996,656,15,"https://fbref.com/en/squads/c539e393/2019-2020/Schalke-04-Stats"
2020,"Schalke 04","Bundesliga","opponent",29,34,683,411,352,254,77,266,687,38.7,421,387,98,289,369,1052,607,8,"https://fbref.com/en/squads/c539e393/2019-2020/Schalke-04-Stats"
2020,"Sevilla","La Liga","team",26,38,587,344,274,246,67,261,661,39.5,400,331,94,237,346,933,704,10,"https://fbref.com/en/squads/ad2be733/2019-2020/Sevilla-Stats"
2020,"Sevilla","La Liga","opponent",26,38,606,380,304,226,76,254,667,38.1,413,385,109,276,430,1036,810,15,"https://fbref.com/en/squads/ad2be733/2019-2020/Sevilla-Stats"
2020,"Sheffield Utd","Premier League","team",26,38,611,377,304,229,78,261,646,40.4,385,336,106,230,420,1031,931,16,"https://fbref.com/en/squads/1df6b87e/2019-2020/Sheffield-United-Stats"
2020,"Sheffield Utd","Premier League","opponent",26,38,481,296,277,167,37,188,534,35.2,346,334,90,244,351,832,903,15,"https://fbref.com/en/squads/1df6b87e/2019-2020/Sheffield-United-Stats"
2020,"Southampton","Premier League","team",25,38,706,416,325,287,94,324,793,40.9,469,488,124,364,425,1131,867,21,"https://fbref.com/en/squads/33c895d4/2019-2020/Southampton-Stats"
2020,"Southampton","Premier League","opponent",25,38,619,362,337,232,50,257,680,37.8,423,407,130,277,428,1047,824,22,"https://fbref.com/en/squads/33c895d4/2019-2020/Southampton-Stats"
2020,"Strasbourg","Ligue 1","team",25,27,472,293,234,193,45,189,403,46.9,214,198,51,147,301,773,436,11,"https://fbref.com/en/squads/c0d3eab4/2019-2020/Strasbourg-Stats"
2020,"Strasbourg","Ligue 1","opponent",25,27,424,266,187,185,52,169,426,39.7,257,210,59,151,277,701,526,8,"https://fbref.com/en/squads/c0d3eab4/2019-2020/Strasbourg-Stats"
2020,"Torino","Serie A","team",27,38,572,314,266,236,70,212,549,38.6,337,433,160,273,495,1067,875,14,"https://fbref.com/en/squads/105360fe/2019-2020/Torino-Stats"
2020,"Torino","Serie A","opponent",27,38,626,375,300,238,88,266,715,37.2,449,365,122,243,347,973,691,11,"https://fbref.com/en/squads/105360fe/2019-2020/Torino-Stats"
2020,"Tottenham","Premier League","team",29,38,665,415,331,281,53,253,681,37.2,428,441,148,293,381,1046,894,24,"https://fbref.com/en/squads/361ca564/2019-2020/Tottenham-Hotspur-Stats"
2020,"Tottenham","Premier League","opponent",29,38,734,410,318,326,90,297,746,39.8,449,409,121,288,450,1184,777,17,"https://fbref.com/en/squads/361ca564/2019-2020/Tottenham-Hotspur-Stats"
2020,"Toulouse","Ligue 1","team",30,28,549,346,270,227,52,220,508,43.3,288,252,77,175,320,869,592,13,"https://fbref.com/en/squads/3f8c4b5f/2019-2020/Toulouse-Stats"
2020,"Toulouse","Ligue 1","opponent",30,28,477,268,223,188,66,184,471,39.1,287,241,81,160,299,776,521,10,"https://fbref.com/en/squads/3f8c4b5f/2019-2020/Toulouse-Stats"
2020,"Udinese","Serie A","team",25,38,597,340,329,214,54,253,593,42.7,340,434,153,281,375,972,789,13,"https://fbref.com/en/squads/04eea015/2019-2020/Udinese-Stats"
2020,"Udinese","Serie A","opponent",25,38,528,312,222,228,78,200,550,36.4,350,366,116,250,322,850,720,15,"https://fbref.com/en/squads/04eea015/2019-2020/Udinese-Stats"
2020,"Union Berlin","Bundesliga","team",26,34,550,322,265,220,65,213,565,37.7,352,396,124,272,421,971,775,8,"https://fbref.com/en/squads/7a41008f/2019-2020/Union-Berlin-Stats"
2020,"Union Berlin","Bundesliga","opponent",26,34,445,303,196,190,59,197,456,43.2,259,358,101,257,357,802,636,9,"https://fbref.com/en/squads/7a41008f/2019-2020/Union-Berlin-Stats"
2020,"Valencia","La Liga","team",28,38,500,310,270,173,57,232,589,39.4,357,334,130,204,362,862,748,12,"https://fbref.com/en/squads/dcc91a7b/2019-2020/Valencia-Stats"
2020,"Valencia","La Liga","opponent",28,38,486,288,207,201,78,203,548,37,345,274,74,200,372,858,634,11,"https://fbref.com/en/squads/dcc91a7b/2019-2020/Valencia-Stats"
2020,"Valladolid","La Liga","team",30,38,568,327,316,204,48,239,672,35.6,433,391,112,279,390,958,749,13,"https://fbref.com/en/squads/17859612/2019-2020/Valladolid-Stats"
2020,"Valladolid","La Liga","opponent",30,38,555,331,240,224,91,231,569,40.6,338,337,93,244,300,855,613,11,"https://fbref.com/en/squads/17859612/2019-2020/Valladolid-Stats"
2020,"Villarreal","La Liga","team",25,38,553,323,250,239,64,218,602,36.2,384,362,116,246,339,892,814,12,"https://fbref.com/en/squads/2a8183b3/2019-2020/Villarreal-Stats"
2020,"Villarreal","La Liga","opponent",25,38,569,337,257,229,83,259,690,37.5,431,353,106,247,369,938,616,9,"https://fbref.com/en/squads/2a8183b3/2019-2020/Villarreal-Stats"
2020,"Watford","Premier League","team",26,38,657,369,347,249,61,267,713,37.4,446,396,135,261,424,1081,869,4,"https://fbref.com/en/squads/2abfe087/2019-2020/Watford-Stats"
2020,"Watford","Premier League","opponent",26,38,603,351,319,210,74,254,575,44.2,321,363,124,239,386,989,818,25,"https://fbref.com/en/squads/2abfe087/2019-2020/Watford-Stats"
2020,"Werder Bremen","Bundesliga","team",30,34,550,345,285,199,66,216,573,37.7,357,369,123,246,423,973,775,11,"https://fbref.com/en/squads/62add3bf/2019-2020/Werder-Bremen-Stats"
2020,"Werder Bremen","Bundesliga","opponent",30,34,537,336,237,235,65,211,470,44.9,259,391,107,284,382,919,676,8,"https://fbref.com/en/squads/62add3bf/2019-2020/Werder-Bremen-Stats"
2020,"West Ham","Premier League","team",29,38,696,417,374,263,59,300,745,40.3,445,383,117,266,421,1117,789,16,"https://fbref.com/en/squads/7c21e445/2019-2020/West-Ham-United-Stats"
2020,"West Ham","Premier League","opponent",29,38,586,333,299,221,66,264,661,39.9,397,369,92,277,392,978,715,10,"https://fbref.com/en/squads/7c21e445/2019-2020/West-Ham-United-Stats"
2020,"Wolfsburg","Bundesliga","team",26,34,598,363,277,247,74,241,589,40.9,348,378,87,291,377,975,649,9,"https://fbref.com/en/squads/4eaa11d7/2019-2020/Wolfsburg-Stats"
2020,"Wolfsburg","Bundesliga","opponent",26,34,633,372,304,259,70,260,612,42.5,352,391,104,287,382,1015,700,6,"https://fbref.com/en/squads/4eaa11d7/2019-2020/Wolfsburg-Stats"
2020,"Wolves","Premier League","team",21,38,646,367,358,227,61,281,685,41,404,378,109,269,437,1083,702,23,"https://fbref.com/en/squads/8cec06e1/2019-2020/Wolverhampton-Wanderers-Stats"
2020,"Wolves","Premier League","opponent",21,38,646,381,292,283,71,308,817,37.7,509,390,135,255,380,1026,817,19,"https://fbref.com/en/squads/8cec06e1/2019-2020/Wolverhampton-Wanderers-Stats"
2021,"Alavés","La Liga","team",30,38,499,292,263,181,55,197,565,34.9,368,341,90,251,427,926,766,8,"https://fbref.com/en/squads/8d6fd021/2020-2021/Alaves-Stats"
2021,"Alavés","La Liga","opponent",30,38,469,279,197,215,57,213,467,45.6,254,309,89,220,342,811,623,12,"https://fbref.com/en/squads/8d6fd021/2020-2021/Alaves-Stats"
2021,"Angers","Ligue 1","team",31,38,626,376,302,256,68,314,754,41.6,440,330,78,252,443,1069,654,1,"https://fbref.com/en/squads/69236f98/2020-2021/Angers-Stats"
2021,"Angers","Ligue 1","opponent",31,38,752,432,379,307,66,358,744,48.1,386,406,100,306,464,1216,625,11,"https://fbref.com/en/squads/69236f98/2020-2021/Angers-Stats"
2021,"Arminia","Bundesliga","team",26,34,552,328,268,229,55,214,536,39.9,322,393,122,271,418,970,739,9,"https://fbref.com/en/squads/247c4b67/2020-2021/Arminia-Stats"
2021,"Arminia","Bundesliga","opponent",26,34,464,279,210,206,48,202,435,46.4,233,341,90,251,346,810,652,6,"https://fbref.com/en/squads/247c4b67/2020-2021/Arminia-Stats"
2021,"Arsenal","Premier League","team",29,38,456,252,206,184,66,212,547,38.8,335,368,113,255,351,807,643,16,"https://fbref.com/en/squads/18bb7c10/2020-2021/Arsenal-Stats"
2021,"Arsenal","Premier League","opponent",29,38,499,285,246,192,61,239,535,44.7,296,391,129,262,369,868,752,16,"https://fbref.com/en/squads/18bb7c10/2020-2021/Arsenal-Stats"
2021,"Aston Villa","Premier League","team",24,38,530,282,262,202,66,250,571,43.8,321,438,159,279,387,917,783,17,"https://fbref.com/en/squads/8602292d/2020-2021/Aston-Villa-Stats"
2021,"Aston Villa","Premier League","opponent",24,38,563,322,309,189,65,226,595,38,369,377,145,232,355,918,804,18,"https://fbref.com/en/squads/8602292d/2020-2021/Aston-Villa-Stats"
2021,"Atalanta","Serie A","team",30,38,606,343,252,256,98,265,591,44.8,326,421,92,329,516,1122,484,11,"https://fbref.com/en/squads/922493f3/2020-2021/Atalanta-Stats"
2021,"Atalanta","Serie A","opponent",30,38,716,407,418,243,55,310,706,43.9,396,494,151,343,528,1244,717,15,"https://fbref.com/en/squads/922493f3/2020-2021/Atalanta-Stats"
2021,"Athletic Club","La Liga","team",27,38,462,269,194,200,68,168,516,32.6,348,341,74,267,344,806,684,9,"https://fbref.com/en/squads/2b390eca/2020-2021/Athletic-Club-Stats"
2021,"Athletic Club","La Liga","opponent",27,38,532,302,265,226,41,197,501,39.3,304,396,94,302,485,1017,772,6,"https://fbref.com/en/squads/2b390eca/2020-2021/Athletic-Club-Stats"
2021,"Atlético Madrid","La Liga","team",25,38,622,367,291,253,78,296,631,46.9,335,361,83,278,386,1008,671,7,"https://fbref.com/en/squads/db3b9613/2020-2021/Atletico-Madrid-Stats"
2021,"Atlético Madrid","La Liga","opponent",25,38,556,315,308,185,63,214,588,36.4,374,359,88,271,454,1010,674,9,"https://fbref.com/en/squads/db3b9613/2020-2021/Atletico-Madrid-Stats"
2021,"Augsburg","Bundesliga","team",25,34,509,308,251,211,47,201,503,40,302,395,116,279,454,963,852,8,"https://fbref.com/en/squads/0cdc4311/2020-2021/Augsburg-Stats"
2021,"Augsburg","Bundesliga","opponent",25,34,513,317,210,229,74,192,474,40.5,282,390,90,300,372,885,530,7,"https://fbref.com/en/squads/0cdc4311/2020-2021/Augsburg-Stats"
2021,"Barcelona","La Liga","team",25,38,499,293,223,195,81,224,522,42.9,298,325,70,255,361,860,429,16,"https://fbref.com/en/squads/206d90db/2020-2021/Barcelona-Stats"
2021,"Barcelona","La Liga","opponent",25,38,598,320,357,181,60,257,770,33.4,513,440,133,307,517,1115,639,8,"https://fbref.com/en/squads/206d90db/2020-2021/Barcelona-Stats"
2021,"Bayern Munich","Bundesliga","team",29,34,510,316,174,231,105,224,541,41.4,317,388,75,313,399,909,398,10,"https://fbref.com/en/squads/054efa67/2020-2021/Bayern-Munich-Stats"
2021,"Bayern Munich","Bundesliga","opponent",29,34,601,328,345,198,58,252,689,36.6,437,449,130,319,456,1057,855,12,"https://fbref.com/en/squads/054efa67/2020-2021/Bayern-Munich-Stats"
2021,"Benevento","Serie A","team",29,38,511,288,278,179,54,243,646,37.6,403,382,123,259,383,894,746,13,"https://fbref.com/en/squads/4fcb34fd/2020-2021/Benevento-Stats"
2021,"Benevento","Serie A","opponent",29,38,468,267,206,181,81,179,452,39.6,273,369,115,254,384,852,680,14,"https://fbref.com/en/squads/4fcb34fd/2020-2021/Benevento-Stats"
2021,"Betis","La Liga","team",25,38,556,315,274,221,61,211,556,37.9,345,362,74,288,453,1009,687,11,"https://fbref.com/en/squads/fc536746/2020-2021/Real-Betis-Stats"
2021,"Betis","La Liga","opponent",25,38,585,335,286,244,55,218,638,34.2,420,407,129,278,367,952,611,12,"https://fbref.com/en/squads/fc536746/2020-2021/Real-Betis-Stats"
2021,"Bologna","Serie A","team",37,38,542,313,273,186,83,209,538,38.8,329,452,147,305,424,966,740,21,"https://fbref.com/en/squads/1d8099f8/2020-2021/Bologna-Stats"
2021,"Bologna","Serie A","opponent",37,38,588,348,281,241,66,283,628,45.1,345,424,128,296,432,1020,637,15,"https://fbref.com/en/squads/1d8099f8/2020-2021/Bologna-Stats"
2021,"Bordeaux","Ligue 1","team",28,38,567,329,294,212,61,253,623,40.6,370,383,123,260,503,1070,677,9,"https://fbref.com/en/squads/123f3efe/2020-2021/Bordeaux-Stats"
2021,"Bordeaux","Ligue 1","opponent",28,38,683,418,334,281,68,287,678,42.3,391,366,100,266,409,1092,590,12,"https://fbref.com/en/squads/123f3efe/2020-2021/Bordeaux-Stats"
2021,"Brest","Ligue 1","team",26,38,610,355,321,236,53,284,633,44.9,349,358,109,249,463,1073,685,12,"https://fbref.com/en/squads/fb08dbb3/2020-2021/Brest-Stats"
2021,"Brest","Ligue 1","opponent",26,38,515,322,244,191,80,230,613,37.5,383,343,101,242,413,928,672,14,"https://fbref.com/en/squads/fb08dbb3/2020-2021/Brest-Stats"
2021,"Brighton","Premier League","team",27,38,628,334,297,251,80,252,603,41.8,351,417,97,320,425,1053,604,8,"https://fbref.com/en/squads/d07537b9/2020-2021/Brighton-and-Hove-Albion-Stats"
2021,"Brighton","Premier League","opponent",27,38,528,316,269,207,52,222,572,38.8,350,417,154,263,456,984,717,15,"https://fbref.com/en/squads/d07537b9/2020-2021/Brighton-and-Hove-Albion-Stats"
2021,"Burnley","Premier League","team",25,38,507,293,241,203,63,229,564,40.6,335,440,180,260,416,923,824,11,"https://fbref.com/en/squads/943e8050/2020-2021/Burnley-Stats"
2021,"Burnley","Premier League","opponent",25,38,447,261,212,193,42,163,397,41.1,234,300,87,213,308,755,811,12,"https://fbref.com/en/squads/943e8050/2020-2021/Burnley-Stats"
2021,"Cagliari","Serie A","team",32,38,589,336,296,229,64,269,647,41.6,378,421,130,291,388,977,777,6,"https://fbref.com/en/squads/c4260e09/2020-2021/Cagliari-Stats"
2021,"Cagliari","Serie A","opponent",32,38,550,312,248,229,73,269,605,44.5,336,410,116,294,414,964,706,9,"https://fbref.com/en/squads/c4260e09/2020-2021/Cagliari-Stats"
2021,"Celta Vigo","La Liga","team",30,38,662,368,332,259,71,238,694,34.3,456,399,89,310,405,1067,751,12,"https://fbref.com/en/squads/f25da7fb/2020-2021/Celta-Vigo-Stats"
2021,"Celta Vigo","La Liga","opponent",30,38,468,288,183,204,81,189,465,40.6,276,344,76,268,489,957,522,6,"https://fbref.com/en/squads/f25da7fb/2020-2021/Celta-Vigo-Stats"
2021,"Chelsea","Premier League","team",27,38,612,341,257,282,73,231,570,40.5,339,420,83,337,382,994,661,16,"https://fbref.com/en/squads/cff3d9bb/2020-2021/Chelsea-Stats"
2021,"Chelsea","Premier League","opponent",27,38,584,313,278,221,85,298,657,45.4,359,464,153,311,430,1014,761,16,"https://fbref.com/en/squads/cff3d9bb/2020-2021/Chelsea-Stats"
2021,"Crotone","Serie A","team",31,38,540,311,288,196,56,225,556,40.5,331,406,137,269,380,920,748,12,"https://fbref.com/en/squads/3074d7b1/2020-2021/Crotone-Stats"
2021,"Crotone","Serie A","opponent",31,38,602,361,240,267,95,237,622,38.1,385,375,83,292,423,1025,522,8,"https://fbref.com/en/squads/3074d7b1/2020-2021/Crotone-Stats"
2021,"Crystal Palace","Premier League","team",24,38,636,366,329,234,73,283,620,45.6,337,447,138,309,396,1032,774,13,"https://fbref.com/en/squads/47c64c55/2020-2021/Crystal-Palace-Stats"
2021,"Crystal Palace","Premier League","opponent",24,38,682,400,281,305,96,280,645,43.4,365,397,97,300,378,1060,597,11,"https://fbref.com/en/squads/47c64c55/2020-2021/Crystal-Palace-Stats"
2021,"Cádiz","La Liga","team",34,38,573,317,305,216,52,247,607,40.7,360,368,99,269,437,1010,788,8,"https://fbref.com/en/squads/ee7c297c/2020-2021/Cadiz-Stats"
2021,"Cádiz","La Liga","opponent",34,38,486,300,217,199,70,192,513,37.4,321,244,41,203,302,788,660,10,"https://fbref.com/en/squads/ee7c297c/2020-2021/Cadiz-Stats"
2021,"Dijon","Ligue 1","team",33,38,601,367,329,225,47,278,661,42.1,383,351,112,239,471,1072,729,16,"https://fbref.com/en/squads/8dfb7350/2020-2021/Dijon-Stats"
2021,"Dijon","Ligue 1","opponent",33,38,654,414,271,291,92,288,673,42.8,385,363,87,276,510,1164,573,9,"https://fbref.com/en/squads/8dfb7350/2020-2021/Dijon-Stats"
2021,"Dortmund","Bundesliga","team",26,34,516,318,221,210,85,219,487,45,268,379,95,284,413,929,472,12,"https://fbref.com/en/squads/add600ae/2020-2021/Dortmund-Stats"
2021,"Dortmund","Bundesliga","opponent",26,34,523,304,273,195,55,229,629,36.4,400,412,120,292,483,1006,665,13,"https://fbref.com/en/squads/add600ae/2020-2021/Dortmund-Stats"
2021,"Eibar","La Liga","team",30,38,514,309,228,204,82,203,518,39.2,315,360,63,297,434,948,593,11,"https://fbref.com/en/squads/bea5c710/2020-2021/Eibar-Stats"
2021,"Eibar","La Liga","opponent",30,38,519,319,285,196,38,199,519,38.3,320,359,98,261,406,925,933,7,"https://fbref.com/en/squads/bea5c710/2020-2021/Eibar-Stats"
2021,"Eint Frankfurt","Bundesliga","team",25,34,594,352,273,245,76,263,596,44.1,333,371,77,294,428,1022,594,10,"https://fbref.com/en/squads/f0ac8ee6/2020-2021/Eintracht-Frankfurt-Stats"
2021,"Eint Frankfurt","Bundesliga","opponent",25,34,549,309,279,217,53,237,514,46.1,277,351,93,258,470,1019,689,9,"https://fbref.com/en/squads/f0ac8ee6/2020-2021/Eintracht-Frankfurt-Stats"
2021,"Elche","La Liga","team",30,38,551,336,324,189,38,210,577,36.4,367,357,97,260,386,937,689,10,"https://fbref.com/en/squads/6c8b07df/2020-2021/Elche-Stats"
2021,"Elche","La Liga","opponent",30,38,598,347,216,281,101,253,618,40.9,365,327,57,270,405,1003,586,8,"https://fbref.com/en/squads/6c8b07df/2020-2021/Elche-Stats"
2021,"Everton","Premier League","team",29,38,640,381,325,242,73,266,664,40.1,398,458,157,301,392,1032,847,19,"https://fbref.com/en/squads/d3fd31cc/2020-2021/Everton-Stats"
2021,"Everton","Premier League","opponent",29,38,573,314,238,242,93,229,591,38.7,362,398,99,299,357,930,655,9,"https://fbref.com/en/squads/d3fd31cc/2020-2021/Everton-Stats"
2021,"Fiorentina","Serie A","team",30,38,496,263,228,198,70,229,544,42.1,315,362,127,235,388,884,619,8,"https://fbref.com/en/squads/421387cf/2020-2021/Fiorentina-Stats"
2021,"Fiorentina","Serie A","opponent",30,38,672,369,334,262,76,250,575,43.5,325,351,86,265,380,1052,753,10,"https://fbref.com/en/squads/421387cf/2020-2021/Fiorentina-Stats"
2021,"Freiburg","Bundesliga","team",24,34,431,247,188,186,57,168,448,37.5,280,365,118,247,452,883,631,8,"https://fbref.com/en/squads/a486e511/2020-2021/Freiburg-Stats"
2021,"Freiburg","Bundesliga","opponent",24,34,424,261,204,171,49,193,423,45.6,230,370,87,283,354,778,617,8,"https://fbref.com/en/squads/a486e511/2020-2021/Freiburg-Stats"
2021,"Fulham","Premier League","team",28,38,601,329,282,231,88,254,581,43.7,327,356,95,261,437,1038,794,13,"https://fbref.com/en/squads/fd962109/2020-2021/Fulham-Stats"
2021,"Fulham","Premier League","opponent",28,38,682,373,323,271,88,289,795,36.4,506,426,121,305,404,1086,729,16,"https://fbref.com/en/squads/fd962109/2020-2021/Fulham-Stats"
2021,"Genoa","Serie A","team",34,38,555,309,293,197,65,255,640,39.8,385,437,123,314,520,1075,785,12,"https://fbref.com/en/squads/658bf2de/2020-2021/Genoa-Stats"
2021,"Genoa","Serie A","opponent",34,38,551,328,256,216,79,246,540,45.6,294,367,91,276,443,994,579,10,"https://fbref.com/en/squads/658bf2de/2020-2021/Genoa-Stats"
2021,"Getafe","La Liga","team",31,38,579,352,232,276,71,241,619,38.9,378,361,53,308,393,972,615,4,"https://fbref.com/en/squads/7848bd64/2020-2021/Getafe-Stats"
2021,"Getafe","La Liga","opponent",31,38,574,313,339,196,39,220,483,45.5,263,352,88,264,390,964,838,3,"https://fbref.com/en/squads/7848bd64/2020-2021/Getafe-Stats"
2021,"Granada","La Liga","team",34,38,499,279,226,213,60,185,468,39.5,283,388,128,260,392,891,764,7,"https://fbref.com/en/squads/a0435291/2020-2021/Granada-Stats"
2021,"Granada","La Liga","opponent",34,38,550,313,265,227,58,204,516,39.5,312,363,78,285,359,909,613,9,"https://fbref.com/en/squads/a0435291/2020-2021/Granada-Stats"
2021,"Hellas Verona","Serie A","team",32,38,465,269,224,183,58,173,413,41.9,240,374,144,230,492,957,756,12,"https://fbref.com/en/squads/0e72edf2/2020-2021/Hellas-Verona-Stats"
2021,"Hellas Verona","Serie A","opponent",32,38,496,297,257,195,44,187,479,39,292,396,107,289,476,972,632,5,"https://fbref.com/en/squads/0e72edf2/2020-2021/Hellas-Verona-Stats"
2021,"Hertha BSC","Bundesliga","team",32,34,485,270,242,201,42,205,493,41.6,288,377,89,288,417,902,687,8,"https://fbref.com/en/squads/2818f8bc/2020-2021/Hertha-BSC-Stats"
2021,"Hertha BSC","Bundesliga","opponent",32,34,552,315,254,244,54,242,571,42.4,329,344,83,261,399,951,579,8,"https://fbref.com/en/squads/2818f8bc/2020-2021/Hertha-BSC-Stats"
2021,"Hoffenheim","Bundesliga","team",30,34,508,296,229,204,75,229,539,42.5,310,370,90,280,431,939,619,8,"https://fbref.com/en/squads/033ea6b8/2020-2021/Hoffenheim-Stats"
2021,"Hoffenheim","Bundesliga","opponent",30,34,554,343,284,220,50,274,553,49.5,279,413,91,322,428,982,644,6,"https://fbref.com/en/squads/033ea6b8/2020-2021/Hoffenheim-Stats"
2021,"Huesca","La Liga","team",27,38,556,321,309,191,56,239,579,41.3,340,342,83,259,437,993,616,7,"https://fbref.com/en/squads/c6c493e6/2020-2021/Huesca-Stats"
2021,"Huesca","La Liga","opponent",27,38,533,309,212,221,100,228,654,34.9,426,325,80,245,323,856,773,14,"https://fbref.com/en/squads/c6c493e6/2020-2021/Huesca-Stats"
2021,"Inter","Serie A","team",25,38,506,286,214,206,86,213,527,40.4,314,383,102,281,371,877,582,8,"https://fbref.com/en/squads/d609edc0/2020-2021/Internazionale-Stats"
2021,"Inter","Serie A","opponent",25,38,455,264,238,164,53,193,453,42.6,260,414,126,288,414,869,693,11,"https://fbref.com/en/squads/d609edc0/2020-2021/Internazionale-Stats"
2021,"Juventus","Serie A","team",30,38,566,323,244,242,80,243,612,39.7,369,390,114,276,458,1024,581,14,"https://fbref.com/en/squads/e0652b02/2020-2021/Juventus-Stats"
2021,"Juventus","Serie A","opponent",30,38,533,303,248,202,83,233,684,34.1,451,427,153,274,402,935,699,7,"https://fbref.com/en/squads/e0652b02/2020-2021/Juventus-Stats"
2021,"Köln","Bundesliga","team",28,34,586,328,299,234,53,248,546,45.4,298,382,101,281,429,1015,670,8,"https://fbref.com/en/squads/bc357bf7/2020-2021/Koln-Stats"
2021,"Köln","Bundesliga","opponent",28,34,446,284,201,177,68,182,420,43.3,238,376,96,280,363,809,618,7,"https://fbref.com/en/squads/bc357bf7/2020-2021/Koln-Stats"
2021,"Lazio","Serie A","team",30,38,595,346,284,244,67,254,678,37.5,424,404,92,312,445,1040,649,7,"https://fbref.com/en/squads/7213da33/2020-2021/Lazio-Stats"
2021,"Lazio","Serie A","opponent",30,38,560,292,270,211,79,256,553,46.3,297,420,124,296,453,1013,781,13,"https://fbref.com/en/squads/7213da33/2020-2021/Lazio-Stats"
2021,"Leeds United","Premier League","team",23,38,740,417,378,279,83,310,769,40.3,459,406,149,257,397,1137,646,26,"https://fbref.com/en/squads/5bfb9659/2020-2021/Leeds-United-Stats"
2021,"Leeds United","Premier League","opponent",23,38,564,318,242,235,87,245,563,43.5,318,448,126,322,426,990,812,14,"https://fbref.com/en/squads/5bfb9659/2020-2021/Leeds-United-Stats"
2021,"Leicester City","Premier League","team",27,38,681,403,319,263,99,295,676,43.6,381,386,90,296,438,1119,685,9,"https://fbref.com/en/squads/a2d435b3/2020-2021/Leicester-City-Stats"
2021,"Leicester City","Premier League","opponent",27,38,609,350,287,250,72,287,645,44.5,358,450,140,310,449,1058,679,15,"https://fbref.com/en/squads/a2d435b3/2020-2021/Leicester-City-Stats"
2021,"Lens","Ligue 1","team",27,38,601,358,264,253,84,237,533,44.5,296,375,92,283,508,1109,690,12,"https://fbref.com/en/squads/fd4e0f7d/2020-2021/Lens-Stats"
2021,"Lens","Ligue 1","opponent",27,38,621,357,287,266,68,273,636,42.9,363,373,101,272,454,1075,676,11,"https://fbref.com/en/squads/fd4e0f7d/2020-2021/Lens-Stats"
2021,"Levante","La Liga","team",29,38,511,282,268,188,55,208,543,38.3,335,335,93,242,435,946,681,15,"https://fbref.com/en/squads/9800b6a1/2020-2021/Levante-Stats"
2021,"Levante","La Liga","opponent",29,38,575,335,287,205,83,249,615,40.5,366,375,76,299,434,1009,638,8,"https://fbref.com/en/squads/9800b6a1/2020-2021/Levante-Stats"
2021,"Leverkusen","Bundesliga","team",30,34,500,282,209,238,53,213,498,42.8,285,368,87,281,322,822,481,10,"https://fbref.com/en/squads/c7a9f859/2020-2021/Bayer-Leverkusen-Stats"
2021,"Leverkusen","Bundesliga","opponent",30,34,619,398,273,270,76,284,710,40,426,400,106,294,428,1047,707,4,"https://fbref.com/en/squads/c7a9f859/2020-2021/Bayer-Leverkusen-Stats"
2021,"Lille","Ligue 1","team",21,38,653,370,273,288,92,305,707,43.1,402,339,90,249,424,1077,590,6,"https://fbref.com/en/squads/cb188c0c/2020-2021/Lille-Stats"
2021,"Lille","Ligue 1","opponent",21,38,677,409,368,240,69,297,705,42.1,408,382,112,270,520,1197,659,19,"https://fbref.com/en/squads/cb188c0c/2020-2021/Lille-Stats"
2021,"Liverpool","Premier League","team",28,38,526,303,195,231,100,220,543,40.5,323,338,58,280,347,873,563,20,"https://fbref.com/en/squads/822bd0ba/2020-2021/Liverpool-Stats"
2021,"Liverpool","Premier League","opponent",28,38,675,343,377,238,60,288,695,41.4,407,469,172,297,456,1131,1057,27,"https://fbref.com/en/squads/822bd0ba/2020-2021/Liverpool-Stats"
2021,"Lorient","Ligue 1","team",27,38,722,424,353,303,66,333,812,41,479,422,114,308,527,1249,670,11,"https://fbref.com/en/squads/d2c87802/2020-2021/Lorient-Stats"
2021,"Lorient","Ligue 1","opponent",27,38,623,370,289,274,60,274,635,43.1,361,340,96,244,450,1073,566,13,"https://fbref.com/en/squads/d2c87802/2020-2021/Lorient-Stats"
2021,"Lyon","Ligue 1","team",29,38,584,346,251,249,84,264,639,41.3,375,366,115,251,408,992,594,14,"https://fbref.com/en/squads/d53c0b06/2020-2021/Lyon-Stats"
2021,"Lyon","Ligue 1","opponent",29,38,660,383,364,234,62,334,813,41.1,479,421,139,282,517,1177,720,21,"https://fbref.com/en/squads/d53c0b06/2020-2021/Lyon-Stats"
2021,"M'Gladbach","Bundesliga","team",23,34,503,307,221,221,61,215,531,40.5,316,424,116,308,436,939,616,6,"https://fbref.com/en/squads/32f3ee20/2020-2021/Monchengladbach-Stats"
2021,"M'Gladbach","Bundesliga","opponent",23,34,513,302,224,230,59,214,533,40.2,319,403,95,308,419,932,605,16,"https://fbref.com/en/squads/32f3ee20/2020-2021/Monchengladbach-Stats"
2021,"Mainz 05","Bundesliga","team",31,34,593,364,266,239,88,258,574,44.9,316,419,109,310,500,1093,662,6,"https://fbref.com/en/squads/a224b06a/2020-2021/Mainz-05-Stats"
2021,"Mainz 05","Bundesliga","opponent",31,34,499,308,228,219,52,220,488,45.1,268,386,89,297,448,947,673,8,"https://fbref.com/en/squads/a224b06a/2020-2021/Mainz-05-Stats"
2021,"Manchester City","Premier League","team",24,38,498,271,198,212,88,234,576,40.6,342,310,82,228,319,817,453,11,"https://fbref.com/en/squads/b8fd03ef/2020-2021/Manchester-City-Stats"
2021,"Manchester City","Premier League","opponent",24,38,647,358,380,219,48,287,772,37.2,485,451,168,283,405,1052,713,28,"https://fbref.com/en/squads/b8fd03ef/2020-2021/Manchester-City-Stats"
2021,"Manchester Utd","Premier League","team",29,38,551,311,252,239,60,231,572,40.4,341,418,116,302,386,937,634,20,"https://fbref.com/en/squads/19538871/2020-2021/Manchester-United-Stats"
2021,"Manchester Utd","Premier League","opponent",29,38,656,369,360,215,81,296,711,41.6,415,511,149,362,478,1134,724,11,"https://fbref.com/en/squads/19538871/2020-2021/Manchester-United-Stats"
2021,"Marseille","Ligue 1","team",31,38,655,391,266,302,87,313,667,46.9,354,365,105,260,442,1097,710,12,"https://fbref.com/en/squads/5725cc7b/2020-2021/Marseille-Stats"
2021,"Marseille","Ligue 1","opponent",31,38,573,336,242,264,67,261,582,44.8,321,380,82,298,442,1015,664,8,"https://fbref.com/en/squads/5725cc7b/2020-2021/Marseille-Stats"
2021,"Metz","Ligue 1","team",27,38,685,417,368,252,65,305,675,45.2,370,394,116,278,572,1257,745,9,"https://fbref.com/en/squads/f83960ae/2020-2021/Metz-Stats"
2021,"Metz","Ligue 1","opponent",27,38,678,384,303,306,69,297,678,43.8,381,355,114,241,393,1071,578,2,"https://fbref.com/en/squads/f83960ae/2020-2021/Metz-Stats"
2021,"Milan","Serie A","team",29,38,627,357,299,257,71,276,605,45.6,329,435,133,302,382,1009,732,13,"https://fbref.com/en/squads/dc56fe14/2020-2021/Milan-Stats"
2021,"Milan","Serie A","opponent",29,38,553,297,285,193,75,254,669,38,415,422,147,275,417,970,711,10,"https://fbref.com/en/squads/dc56fe14/2020-2021/Milan-Stats"
2021,"Monaco","Ligue 1","team",30,38,733,432,296,346,91,332,696,47.7,364,356,66,290,436,1169,513,15,"https://fbref.com/en/squads/fd6114db/2020-2021/Monaco-Stats"
2021,"Monaco","Ligue 1","opponent",30,38,566,334,279,224,63,262,570,46,308,374,119,255,503,1069,732,17,"https://fbref.com/en/squads/fd6114db/2020-2021/Monaco-Stats"
2021,"Montpellier","Ligue 1","team",25,38,529,334,301,183,45,284,707,40.2,423,372,150,222,420,949,705,14,"https://fbref.com/en/squads/281b0e73/2020-2021/Montpellier-Stats"
2021,"Montpellier","Ligue 1","opponent",25,38,588,326,277,239,72,288,587,49.1,299,345,106,239,414,1002,750,6,"https://fbref.com/en/squads/281b0e73/2020-2021/Montpellier-Stats"
2021,"Nantes","Ligue 1","team",25,38,697,385,357,270,70,369,778,47.4,409,391,107,284,464,1161,707,6,"https://fbref.com/en/squads/d7a486cd/2020-2021/Nantes-Stats"
2021,"Nantes","Ligue 1","opponent",25,38,668,411,329,268,71,300,678,44.2,378,355,104,251,460,1128,691,11,"https://fbref.com/en/squads/d7a486cd/2020-2021/Nantes-Stats"
2021,"Napoli","Serie A","team",25,38,574,345,280,213,81,257,635,40.5,378,381,98,283,369,943,532,17,"https://fbref.com/en/squads/d48ad4ff/2020-2021/Napoli-Stats"
2021,"Napoli","Serie A","opponent",25,38,497,278,259,173,65,242,628,38.5,386,466,170,296,403,900,644,17,"https://fbref.com/en/squads/d48ad4ff/2020-2021/Napoli-Stats"
2021,"Newcastle Utd","Premier League","team",27,38,512,268,257,213,42,207,547,37.8,340,423,160,263,362,874,908,10,"https://fbref.com/en/squads/b2b47a98/2020-2021/Newcastle-United-Stats"
2021,"Newcastle Utd","Premier League","opponent",27,38,534,276,232,223,79,237,587,40.4,350,387,115,272,372,906,632,9,"https://fbref.com/en/squads/b2b47a98/2020-2021/Newcastle-United-Stats"
2021,"Nice","Ligue 1","team",31,38,599,364,281,243,75,256,628,40.8,372,355,123,232,435,1034,644,15,"https://fbref.com/en/squads/132ebc33/2020-2021/Nice-Stats"
2021,"Nice","Ligue 1","opponent",31,38,667,403,298,274,95,301,741,40.6,440,363,96,267,473,1140,583,19,"https://fbref.com/en/squads/132ebc33/2020-2021/Nice-Stats"
2021,"Nîmes","Ligue 1","team",33,38,625,372,301,244,80,310,709,43.7,399,407,122,285,501,1126,710,17,"https://fbref.com/en/squads/1cbf5f9e/2020-2021/Nimes-Stats"
2021,"Nîmes","Ligue 1","opponent",33,38,658,419,292,288,78,296,616,48.1,320,341,89,252,444,1102,615,6,"https://fbref.com/en/squads/1cbf5f9e/2020-2021/Nimes-Stats"
2021,"Osasuna","La Liga","team",28,38,524,281,223,217,84,224,552,40.6,328,349,100,249,392,916,774,7,"https://fbref.com/en/squads/03c57e2b/2020-2021/Osasuna-Stats"
2021,"Osasuna","La Liga","opponent",28,38,505,309,252,195,58,195,440,44.3,245,312,79,233,340,845,694,7,"https://fbref.com/en/squads/03c57e2b/2020-2021/Osasuna-Stats"
2021,"Paris S-G","Ligue 1","team",33,38,609,385,217,278,114,293,700,41.9,407,327,81,246,373,982,448,22,"https://fbref.com/en/squads/e2d8892c/2020-2021/Paris-Saint-Germain-Stats"
2021,"Paris S-G","Ligue 1","opponent",33,38,706,385,402,217,87,358,847,42.3,489,340,103,237,535,1241,671,22,"https://fbref.com/en/squads/e2d8892c/2020-2021/Paris-Saint-Germain-Stats"
2021,"Parma","Serie A","team",42,38,585,317,317,215,53,269,695,38.7,426,412,116,296,463,1048,806,14,"https://fbref.com/en/squads/eab4234c/2020-2021/Parma-Stats"
2021,"Parma","Serie A","opponent",42,38,519,302,221,209,89,227,589,38.5,362,362,96,266,414,933,593,7,"https://fbref.com/en/squads/eab4234c/2020-2021/Parma-Stats"
2021,"RB Leipzig","Bundesliga","team",25,34,460,305,167,229,64,190,460,41.3,270,336,63,273,353,813,504,5,"https://fbref.com/en/squads/acbb6a5b/2020-2021/RB-Leipzig-Stats"
2021,"RB Leipzig","Bundesliga","opponent",25,34,534,303,244,227,63,208,523,39.8,315,429,127,302,520,1054,696,9,"https://fbref.com/en/squads/acbb6a5b/2020-2021/RB-Leipzig-Stats"
2021,"Real Madrid","La Liga","team",30,38,531,318,266,188,77,192,532,36.1,340,344,83,261,401,932,544,12,"https://fbref.com/en/squads/53a2f082/2020-2021/Real-Madrid-Stats"
2021,"Real Madrid","La Liga","opponent",30,38,531,295,277,184,70,216,645,33.5,429,418,133,285,380,911,707,16,"https://fbref.com/en/squads/53a2f082/2020-2021/Real-Madrid-Stats"
2021,"Real Sociedad","La Liga","team",30,38,547,322,240,227,80,200,480,41.7,280,353,96,257,315,862,563,5,"https://fbref.com/en/squads/e31d1cd9/2020-2021/Real-Sociedad-Stats"
2021,"Real Sociedad","La Liga","opponent",30,38,531,311,253,212,66,220,550,40,330,413,104,309,379,910,710,16,"https://fbref.com/en/squads/e31d1cd9/2020-2021/Real-Sociedad-Stats"
2021,"Reims","Ligue 1","team",29,38,656,372,336,242,78,276,645,42.8,369,335,121,214,487,1143,762,18,"https://fbref.com/en/squads/7fdd64e0/2020-2021/Reims-Stats"
2021,"Reims","Ligue 1","opponent",29,38,575,336,257,218,100,298,669,44.5,371,272,77,195,455,1030,524,9,"https://fbref.com/en/squads/7fdd64e0/2020-2021/Reims-Stats"
2021,"Rennes","Ligue 1","team",32,38,587,337,242,254,91,234,564,41.5,330,347,74,273,361,948,510,12,"https://fbref.com/en/squads/b3072e00/2020-2021/Rennes-Stats"
2021,"Rennes","Ligue 1","opponent",32,38,552,318,291,213,48,265,671,39.5,406,379,130,249,519,1071,748,14,"https://fbref.com/en/squads/b3072e00/2020-2021/Rennes-Stats"
2021,"Roma","Serie A","team",31,38,478,273,192,218,68,206,582,35.4,376,360,83,277,489,967,521,26,"https://fbref.com/en/squads/cf74a709/2020-2021/Roma-Stats"
2021,"Roma","Serie A","opponent",31,38,490,290,257,180,53,266,663,40.1,397,421,137,284,452,942,637,16,"https://fbref.com/en/squads/cf74a709/2020-2021/Roma-Stats"
2021,"Saint-Étienne","Ligue 1","team",40,38,716,428,394,253,69,326,700,46.6,374,374,88,286,471,1187,665,10,"https://fbref.com/en/squads/d298ef2c/2020-2021/Saint-Etienne-Stats"
2021,"Saint-Étienne","Ligue 1","opponent",40,38,733,435,320,309,104,370,802,46.1,432,377,106,271,447,1180,704,8,"https://fbref.com/en/squads/d298ef2c/2020-2021/Saint-Etienne-Stats"
2021,"Sampdoria","Serie A","team",27,38,576,326,275,235,66,251,634,39.6,383,470,154,316,453,1029,745,6,"https://fbref.com/en/squads/8ff9e3b3/2020-2021/Sampdoria-Stats"
2021,"Sampdoria","Serie A","opponent",27,38,479,293,210,200,69,192,484,39.7,292,396,125,271,460,939,785,16,"https://fbref.com/en/squads/8ff9e3b3/2020-2021/Sampdoria-Stats"
2021,"Sassuolo","Serie A","team",28,38,528,310,276,164,88,241,543,44.4,302,383,141,242,426,954,629,11,"https://fbref.com/en/squads/e2befd26/2020-2021/Sassuolo-Stats"
2021,"Sassuolo","Serie A","opponent",28,38,603,345,332,194,77,290,718,40.4,428,445,155,290,442,1045,631,10,"https://fbref.com/en/squads/e2befd26/2020-2021/Sassuolo-Stats"
2021,"Schalke 04","Bundesliga","team",42,34,552,337,283,224,45,203,546,37.2,343,437,143,294,411,963,693,12,"https://fbref.com/en/squads/c539e393/2020-2021/Schalke-04-Stats"
2021,"Schalke 04","Bundesliga","opponent",42,34,636,370,211,309,116,284,617,46,333,380,83,297,378,1014,447,7,"https://fbref.com/en/squads/c539e393/2020-2021/Schalke-04-Stats"
2021,"Sevilla","La Liga","team",26,38,492,297,220,200,72,184,510,36.1,326,310,90,220,362,854,636,10,"https://fbref.com/en/squads/ad2be733/2020-2021/Sevilla-Stats"
2021,"Sevilla","La Liga","opponent",26,38,516,306,255,196,65,207,599,34.6,392,325,87,238,407,923,635,13,"https://fbref.com/en/squads/ad2be733/2020-2021/Sevilla-Stats"
2021,"Sheffield Utd","Premier League","team",27,38,634,356,325,239,70,294,720,40.8,426,442,152,290,351,985,839,19,"https://fbref.com/en/squads/1df6b87e/2020-2021/Sheffield-United-Stats"
2021,"Sheffield Utd","Premier League","opponent",27,38,529,301,288,177,64,206,475,43.4,269,353,91,262,296,825,690,9,"https://fbref.com/en/squads/1df6b87e/2020-2021/Sheffield-United-Stats"
2021,"Southampton","Premier League","team",29,38,727,419,335,325,67,341,731,46.6,390,439,95,344,401,1128,681,10,"https://fbref.com/en/squads/33c895d4/2020-2021/Southampton-Stats"
2021,"Southampton","Premier League","opponent",29,38,644,355,236,315,93,258,601,42.9,343,399,98,301,428,1072,680,14,"https://fbref.com/en/squads/33c895d4/2020-2021/Southampton-Stats"
2021,"Spezia","Serie A","team",35,38,568,320,264,223,81,265,617,42.9,352,364,101,263,394,962,551,12,"https://fbref.com/en/squads/68449f6d/2020-2021/Spezia-Stats"
2021,"Spezia","Serie A","opponent",35,38,501,280,246,208,47,206,528,39,322,362,89,273,459,960,644,12,"https://fbref.com/en/squads/68449f6d/2020-2021/Spezia-Stats"
2021,"Strasbourg","Ligue 1","team",26,38,633,396,313,247,73,280,615,45.5,335,303,77,226,521,1154,641,11,"https://fbref.com/en/squads/c0d3eab4/2020-2021/Strasbourg-Stats"
2021,"Strasbourg","Ligue 1","opponent",26,38,539,346,233,232,74,209,508,41.1,299,375,101,274,408,947,708,10,"https://fbref.com/en/squads/c0d3eab4/2020-2021/Strasbourg-Stats"
2021,"Stuttgart","Bundesliga","team",29,34,496,294,227,201,68,235,531,44.3,296,379,108,271,426,922,654,8,"https://fbref.com/en/squads/598bc722/2020-2021/Stuttgart-Stats"
2021,"Stuttgart","Bundesliga","opponent",29,34,665,394,279,290,96,255,668,38.2,413,433,111,322,455,1120,564,4,"https://fbref.com/en/squads/598bc722/2020-2021/Stuttgart-Stats"
2021,"Torino","Serie A","team",29,38,530,306,241,205,84,247,569,43.4,322,412,127,285,444,974,727,13,"https://fbref.com/en/squads/105360fe/2020-2021/Torino-Stats"
2021,"Torino","Serie A","opponent",29,38,543,306,232,235,76,246,634,38.8,388,394,116,278,385,928,677,20,"https://fbref.com/en/squads/105360fe/2020-2021/Torino-Stats"
2021,"Tottenham","Premier League","team",24,38,636,361,313,244,79,277,683,40.6,406,434,147,287,342,978,795,15,"https://fbref.com/en/squads/361ca564/2020-2021/Tottenham-Hotspur-Stats"
2021,"Tottenham","Premier League","opponent",24,38,646,381,310,260,76,312,715,43.6,403,433,107,326,429,1075,615,15,"https://fbref.com/en/squads/361ca564/2020-2021/Tottenham-Hotspur-Stats"
2021,"Udinese","Serie A","team",33,38,502,294,264,199,39,209,547,38.2,338,428,131,297,440,942,683,8,"https://fbref.com/en/squads/04eea015/2020-2021/Udinese-Stats"
2021,"Udinese","Serie A","opponent",33,38,563,296,244,242,77,233,609,38.3,376,362,100,262,444,1007,672,19,"https://fbref.com/en/squads/04eea015/2020-2021/Udinese-Stats"
2021,"Union Berlin","Bundesliga","team",27,34,503,283,240,218,45,232,501,46.3,269,367,85,282,405,908,605,9,"https://fbref.com/en/squads/7a41008f/2020-2021/Union-Berlin-Stats"
2021,"Union Berlin","Bundesliga","opponent",27,34,413,265,165,193,55,183,389,47,206,354,90,264,401,814,640,7,"https://fbref.com/en/squads/7a41008f/2020-2021/Union-Berlin-Stats"
2021,"Valencia","La Liga","team",30,38,463,277,241,163,59,198,592,33.4,394,372,123,249,391,854,785,12,"https://fbref.com/en/squads/dcc91a7b/2020-2021/Valencia-Stats"
2021,"Valencia","La Liga","opponent",30,38,480,295,210,198,72,212,553,38.3,341,332,93,239,391,871,540,9,"https://fbref.com/en/squads/dcc91a7b/2020-2021/Valencia-Stats"
2021,"Valladolid","La Liga","team",32,38,559,321,285,208,66,247,681,36.3,434,379,102,277,431,990,812,9,"https://fbref.com/en/squads/17859612/2020-2021/Valladolid-Stats"
2021,"Valladolid","La Liga","opponent",32,38,541,314,256,206,79,213,504,42.3,291,311,74,237,367,908,701,12,"https://fbref.com/en/squads/17859612/2020-2021/Valladolid-Stats"
2021,"Villarreal","La Liga","team",29,38,539,313,256,205,78,239,588,40.6,349,358,101,257,371,910,638,17,"https://fbref.com/en/squads/2a8183b3/2020-2021/Villarreal-Stats"
2021,"Villarreal","La Liga","opponent",29,38,591,324,280,223,88,255,692,36.8,437,394,94,300,416,1007,617,12,"https://fbref.com/en/squads/2a8183b3/2020-2021/Villarreal-Stats"
2021,"Werder Bremen","Bundesliga","team",27,34,542,333,270,217,55,228,556,41,328,368,101,267,407,949,798,10,"https://fbref.com/en/squads/62add3bf/2020-2021/Werder-Bremen-Stats"
2021,"Werder Bremen","Bundesliga","opponent",27,34,447,270,181,204,62,179,367,48.8,188,344,82,262,413,860,517,7,"https://fbref.com/en/squads/62add3bf/2020-2021/Werder-Bremen-Stats"
2021,"West Brom","Premier League","team",30,38,581,328,329,192,60,271,656,41.3,385,455,159,296,435,1016,876,13,"https://fbref.com/en/squads/60c6b05f/2020-2021/West-Bromwich-Albion-Stats"
2021,"West Brom","Premier League","opponent",30,38,554,328,256,235,63,241,505,47.7,264,296,75,221,328,882,672,13,"https://fbref.com/en/squads/60c6b05f/2020-2021/West-Bromwich-Albion-Stats"
2021,"West Ham","Premier League","team",24,38,514,280,269,195,50,224,573,39.1,349,405,124,281,437,951,779,11,"https://fbref.com/en/squads/7c21e445/2020-2021/West-Ham-United-Stats"
2021,"West Ham","Premier League","opponent",24,38,562,328,279,218,65,244,542,45,298,405,116,289,364,926,710,9,"https://fbref.com/en/squads/7c21e445/2020-2021/West-Ham-United-Stats"
2021,"Wolfsburg","Bundesliga","team",26,34,594,363,271,256,67,271,599,45.2,328,465,79,386,477,1071,700,6,"https://fbref.com/en/squads/4eaa11d7/2020-2021/Wolfsburg-Stats"
2021,"Wolfsburg","Bundesliga","opponent",26,34,482,281,234,195,53,186,482,38.6,296,408,111,297,445,927,677,15,"https://fbref.com/en/squads/4eaa11d7/2020-2021/Wolfsburg-Stats"
2021,"Wolves","Premier League","team",27,38,588,335,322,220,46,277,611,45.3,334,359,117,242,432,1020,727,15,"https://fbref.com/en/squads/8cec06e1/2020-2021/Wolverhampton-Wanderers-Stats"
2021,"Wolves","Premier League","opponent",27,38,620,339,288,276,56,311,779,39.9,468,387,129,258,345,965,706,15,"https://fbref.com/en/squads/8cec06e1/2020-2021/Wolverhampton-Wanderers-Stats"
2022,"Alavés","La Liga","team",33,38,550,322,271,221,58,262,637,41.1,375,373,106,267,375,925,890,7,"https://fbref.com/en/squads/8d6fd021/2021-2022/Alaves-Stats"
2022,"Alavés","La Liga","opponent",33,38,511,273,249,193,69,233,504,46.2,271,351,87,264,311,822,729,12,"https://fbref.com/en/squads/8d6fd021/2021-2022/Alaves-Stats"
2022,"Angers","Ligue 1","team",30,38,619,370,301,253,65,284,659,43.1,375,384,99,285,423,1042,631,9,"https://fbref.com/en/squads/69236f98/2021-2022/Angers-Stats"
2022,"Angers","Ligue 1","opponent",30,38,811,504,365,344,102,438,839,52.2,401,347,89,258,423,1234,538,11,"https://fbref.com/en/squads/69236f98/2021-2022/Angers-Stats"
2022,"Arminia","Bundesliga","team",26,34,549,311,270,235,44,238,543,43.8,305,395,110,285,421,970,770,7,"https://fbref.com/en/squads/247c4b67/2021-2022/Arminia-Stats"
2022,"Arminia","Bundesliga","opponent",26,34,590,345,270,242,78,283,567,49.9,284,400,108,292,349,939,653,11,"https://fbref.com/en/squads/247c4b67/2021-2022/Arminia-Stats"
2022,"Arsenal","Premier League","team",27,38,540,311,261,195,84,244,500,48.8,256,386,123,263,296,836,658,20,"https://fbref.com/en/squads/18bb7c10/2021-2022/Arsenal-Stats"
2022,"Arsenal","Premier League","opponent",27,38,608,339,314,212,82,271,590,45.9,319,427,164,263,364,972,737,18,"https://fbref.com/en/squads/18bb7c10/2021-2022/Arsenal-Stats"
2022,"Aston Villa","Premier League","team",31,38,634,382,300,259,75,300,649,46.2,349,453,140,313,339,973,693,13,"https://fbref.com/en/squads/8602292d/2021-2022/Aston-Villa-Stats"
2022,"Aston Villa","Premier League","opponent",31,38,598,343,278,246,74,254,587,43.3,333,356,127,229,339,937,743,6,"https://fbref.com/en/squads/8602292d/2021-2022/Aston-Villa-Stats"
2022,"Atalanta","Serie A","team",32,38,630,341,252,271,107,299,635,47.1,336,436,96,340,441,1071,483,6,"https://fbref.com/en/squads/922493f3/2021-2022/Atalanta-Stats"
2022,"Atalanta","Serie A","opponent",32,38,683,407,385,234,64,307,679,45.2,372,515,184,331,429,1112,721,8,"https://fbref.com/en/squads/922493f3/2021-2022/Atalanta-Stats"
2022,"Athletic Club","La Liga","team",26,38,508,292,217,216,75,224,582,38.5,358,411,128,283,339,847,788,8,"https://fbref.com/en/squads/2b390eca/2021-2022/Athletic-Club-Stats"
2022,"Athletic Club","La Liga","opponent",26,38,573,353,293,224,56,232,529,43.9,297,393,131,262,387,960,817,14,"https://fbref.com/en/squads/2b390eca/2021-2022/Athletic-Club-Stats"
2022,"Atlético Madrid","La Liga","team",26,38,636,346,290,279,67,293,619,47.3,326,372,98,274,365,1001,649,14,"https://fbref.com/en/squads/db3b9613/2021-2022/Atletico-Madrid-Stats"
2022,"Atlético Madrid","La Liga","opponent",26,38,570,308,297,201,72,217,600,36.2,383,364,103,261,403,973,803,10,"https://fbref.com/en/squads/db3b9613/2021-2022/Atletico-Madrid-Stats"
2022,"Augsburg","Bundesliga","team",26,34,561,335,254,236,71,250,584,42.8,334,397,116,281,363,924,769,12,"https://fbref.com/en/squads/0cdc4311/2021-2022/Augsburg-Stats"
2022,"Augsburg","Bundesliga","opponent",26,34,547,324,254,231,62,249,511,48.7,262,337,81,256,361,908,606,11,"https://fbref.com/en/squads/0cdc4311/2021-2022/Augsburg-Stats"
2022,"Barcelona","La Liga","team",38,38,587,331,236,270,81,244,493,49.5,249,346,85,261,325,912,467,17,"https://fbref.com/en/squads/206d90db/2021-2022/Barcelona-Stats"
2022,"Barcelona","La Liga","opponent",38,38,631,352,309,250,72,273,747,36.5,474,376,109,267,392,1023,809,10,"https://fbref.com/en/squads/206d90db/2021-2022/Barcelona-Stats"
2022,"Bayern Munich","Bundesliga","team",30,34,563,338,231,237,95,259,559,46.3,300,338,68,270,349,912,404,18,"https://fbref.com/en/squads/054efa67/2021-2022/Bayern-Munich-Stats"
2022,"Bayern Munich","Bundesliga","opponent",30,34,678,386,367,236,75,340,832,40.9,492,457,154,303,498,1176,798,22,"https://fbref.com/en/squads/054efa67/2021-2022/Bayern-Munich-Stats"
2022,"Betis","La Liga","team",31,38,662,392,322,261,79,324,695,46.6,371,386,112,274,361,1023,777,11,"https://fbref.com/en/squads/fc536746/2021-2022/Real-Betis-Stats"
2022,"Betis","La Liga","opponent",31,38,647,370,331,254,62,282,654,43.1,372,416,135,281,375,1022,614,11,"https://fbref.com/en/squads/fc536746/2021-2022/Real-Betis-Stats"
2022,"Bochum","Bundesliga","team",28,34,566,353,298,199,69,277,574,48.3,297,420,119,301,429,995,616,13,"https://fbref.com/en/squads/b42c6323/2021-2022/Bochum-Stats"
2022,"Bochum","Bundesliga","opponent",28,34,498,314,242,205,51,216,442,48.9,226,313,86,227,293,791,591,13,"https://fbref.com/en/squads/b42c6323/2021-2022/Bochum-Stats"
2022,"Bologna","Serie A","team",36,38,530,298,261,202,67,216,528,40.9,312,384,127,257,370,900,678,5,"https://fbref.com/en/squads/1d8099f8/2021-2022/Bologna-Stats"
2022,"Bologna","Serie A","opponent",36,38,574,321,237,231,106,272,598,45.5,326,383,108,275,376,950,618,8,"https://fbref.com/en/squads/1d8099f8/2021-2022/Bologna-Stats"
2022,"Bordeaux","Ligue 1","team",39,38,642,377,321,243,78,323,741,43.6,418,357,104,253,454,1096,688,19,"https://fbref.com/en/squads/123f3efe/2021-2022/Bordeaux-Stats"
2022,"Bordeaux","Ligue 1","opponent",39,38,615,377,283,258,74,302,657,46,355,394,122,272,397,1012,641,15,"https://fbref.com/en/squads/123f3efe/2021-2022/Bordeaux-Stats"
2022,"Brentford","Premier League","team",29,38,607,342,299,228,80,291,616,47.2,325,383,113,270,393,1000,863,7,"https://fbref.com/en/squads/cd051869/2021-2022/Brentford-Stats"
2022,"Brentford","Premier League","opponent",29,38,505,285,216,225,64,214,476,45,262,423,132,291,381,886,830,12,"https://fbref.com/en/squads/cd051869/2021-2022/Brentford-Stats"
2022,"Brest","Ligue 1","team",25,38,682,400,342,249,91,310,655,47.3,345,369,108,261,469,1151,707,4,"https://fbref.com/en/squads/fb08dbb3/2021-2022/Brest-Stats"
2022,"Brest","Ligue 1","opponent",25,38,637,390,340,244,53,325,640,50.8,315,341,88,253,366,1003,616,4,"https://fbref.com/en/squads/fb08dbb3/2021-2022/Brest-Stats"
2022,"Brighton","Premier League","team",26,38,668,403,306,257,105,243,563,43.2,320,480,150,330,358,1026,723,12,"https://fbref.com/en/squads/d07537b9/2021-2022/Brighton-and-Hove-Albion-Stats"
2022,"Brighton","Premier League","opponent",26,38,591,358,301,224,66,242,559,43.3,317,481,140,341,389,980,752,8,"https://fbref.com/en/squads/d07537b9/2021-2022/Brighton-and-Hove-Albion-Stats"
2022,"Burnley","Premier League","team",23,38,590,324,273,235,82,250,534,46.8,284,509,211,298,410,1000,887,18,"https://fbref.com/en/squads/943e8050/2021-2022/Burnley-Stats"
2022,"Burnley","Premier League","opponent",23,38,512,306,249,202,61,221,479,46.1,258,369,104,265,280,792,853,9,"https://fbref.com/en/squads/943e8050/2021-2022/Burnley-Stats"
2022,"Cagliari","Serie A","team",33,38,557,303,263,229,65,230,544,42.3,314,406,128,278,397,954,747,5,"https://fbref.com/en/squads/c4260e09/2021-2022/Cagliari-Stats"
2022,"Cagliari","Serie A","opponent",33,38,488,275,209,212,67,227,479,47.4,252,390,117,273,306,794,637,9,"https://fbref.com/en/squads/c4260e09/2021-2022/Cagliari-Stats"
2022,"Celta Vigo","La Liga","team",25,38,696,409,324,279,93,286,762,37.5,476,423,91,332,376,1072,634,11,"https://fbref.com/en/squads/f25da7fb/2021-2022/Celta-Vigo-Stats"
2022,"Celta Vigo","La Liga","opponent",25,38,554,324,236,237,81,244,590,41.4,346,410,97,313,454,1008,776,14,"https://fbref.com/en/squads/f25da7fb/2021-2022/Celta-Vigo-Stats"
2022,"Chelsea","Premier League","team",26,38,621,348,267,269,85,257,567,45.3,310,408,96,312,347,968,641,15,"https://fbref.com/en/squads/cff3d9bb/2021-2022/Chelsea-Stats"
2022,"Chelsea","Premier League","opponent",26,38,643,356,337,237,69,260,624,41.7,364,487,169,318,376,1019,793,12,"https://fbref.com/en/squads/cff3d9bb/2021-2022/Chelsea-Stats"
2022,"Clermont Foot","Ligue 1","team",28,38,622,361,285,262,75,291,665,43.8,374,372,99,273,386,1008,527,9,"https://fbref.com/en/squads/d9676424/2021-2022/Clermont-Foot-Stats"
2022,"Clermont Foot","Ligue 1","opponent",28,38,682,393,288,293,101,272,599,45.4,327,395,103,292,475,1157,642,9,"https://fbref.com/en/squads/d9676424/2021-2022/Clermont-Foot-Stats"
2022,"Crystal Palace","Premier League","team",24,38,637,374,323,236,78,273,575,47.5,302,452,135,317,333,970,761,5,"https://fbref.com/en/squads/47c64c55/2021-2022/Crystal-Palace-Stats"
2022,"Crystal Palace","Premier League","opponent",24,38,776,440,354,310,112,305,687,44.4,382,386,110,276,378,1154,712,16,"https://fbref.com/en/squads/47c64c55/2021-2022/Crystal-Palace-Stats"
2022,"Cádiz","La Liga","team",33,38,647,380,346,238,63,301,711,42.3,410,390,106,284,413,1060,768,5,"https://fbref.com/en/squads/ee7c297c/2021-2022/Cadiz-Stats"
2022,"Cádiz","La Liga","opponent",33,38,529,312,265,197,67,238,519,45.9,281,328,89,239,323,852,792,12,"https://fbref.com/en/squads/ee7c297c/2021-2022/Cadiz-Stats"
2022,"Dortmund","Bundesliga","team",33,34,541,322,232,236,73,255,550,46.4,295,351,82,269,347,888,519,11,"https://fbref.com/en/squads/add600ae/2021-2022/Dortmund-Stats"
2022,"Dortmund","Bundesliga","opponent",33,34,594,342,292,229,73,284,636,44.7,352,402,104,298,481,1075,573,12,"https://fbref.com/en/squads/add600ae/2021-2022/Dortmund-Stats"
2022,"Eint Frankfurt","Bundesliga","team",27,34,595,330,260,252,83,283,673,42.1,390,435,95,340,377,972,592,12,"https://fbref.com/en/squads/f0ac8ee6/2021-2022/Eintracht-Frankfurt-Stats"
2022,"Eint Frankfurt","Bundesliga","opponent",27,34,552,317,285,209,58,258,543,47.5,285,420,125,295,417,969,721,10,"https://fbref.com/en/squads/f0ac8ee6/2021-2022/Eintracht-Frankfurt-Stats"
2022,"Elche","La Liga","team",28,38,589,325,335,191,63,268,622,43.1,354,367,126,241,305,894,769,14,"https://fbref.com/en/squads/6c8b07df/2021-2022/Elche-Stats"
2022,"Elche","La Liga","opponent",28,38,588,345,244,268,76,258,597,43.2,339,363,87,276,359,947,617,9,"https://fbref.com/en/squads/6c8b07df/2021-2022/Elche-Stats"
2022,"Empoli","Serie A","team",28,38,568,327,268,208,92,273,606,45,333,451,177,274,352,920,772,10,"https://fbref.com/en/squads/a3d88bd8/2021-2022/Empoli-Stats"
2022,"Empoli","Serie A","opponent",28,38,590,361,283,215,92,255,546,46.7,291,434,142,292,377,967,706,7,"https://fbref.com/en/squads/a3d88bd8/2021-2022/Empoli-Stats"
2022,"Espanyol","La Liga","team",34,38,557,338,308,196,53,275,646,42.6,371,360,114,246,326,883,892,20,"https://fbref.com/en/squads/a8661628/2021-2022/Espanyol-Stats"
2022,"Espanyol","La Liga","opponent",34,38,574,350,248,249,77,243,616,39.4,373,338,98,240,287,861,591,4,"https://fbref.com/en/squads/a8661628/2021-2022/Espanyol-Stats"
2022,"Everton","Premier League","team",33,38,705,402,369,252,84,336,735,45.7,399,496,140,356,365,1070,815,15,"https://fbref.com/en/squads/d3fd31cc/2021-2022/Everton-Stats"
2022,"Everton","Premier League","opponent",33,38,620,336,298,240,82,295,632,46.7,337,443,146,297,333,953,653,6,"https://fbref.com/en/squads/d3fd31cc/2021-2022/Everton-Stats"
2022,"Fiorentina","Serie A","team",28,38,508,301,232,203,73,268,540,49.6,272,357,91,266,244,752,407,15,"https://fbref.com/en/squads/421387cf/2021-2022/Fiorentina-Stats"
2022,"Fiorentina","Serie A","opponent",28,38,515,289,264,191,60,240,541,44.4,301,386,119,267,351,866,687,4,"https://fbref.com/en/squads/421387cf/2021-2022/Fiorentina-Stats"
2022,"Freiburg","Bundesliga","team",26,34,518,299,246,207,65,215,477,45.1,262,352,130,222,355,873,751,13,"https://fbref.com/en/squads/a486e511/2021-2022/Freiburg-Stats"
2022,"Freiburg","Bundesliga","opponent",26,34,413,239,181,161,71,194,420,46.2,226,387,100,287,333,746,692,11,"https://fbref.com/en/squads/a486e511/2021-2022/Freiburg-Stats"
2022,"Genoa","Serie A","team",40,38,739,416,324,302,113,349,727,48,378,487,134,353,449,1188,751,15,"https://fbref.com/en/squads/658bf2de/2021-2022/Genoa-Stats"
2022,"Genoa","Serie A","opponent",40,38,651,370,277,304,70,278,580,47.9,302,418,105,313,350,1001,736,7,"https://fbref.com/en/squads/658bf2de/2021-2022/Genoa-Stats"
2022,"Getafe","La Liga","team",31,38,587,360,266,243,78,248,594,41.8,346,400,96,304,401,988,719,8,"https://fbref.com/en/squads/7848bd64/2021-2022/Getafe-Stats"
2022,"Getafe","La Liga","opponent",31,38,511,279,204,239,68,210,452,46.5,242,343,106,237,357,868,668,8,"https://fbref.com/en/squads/7848bd64/2021-2022/Getafe-Stats"
2022,"Granada","La Liga","team",32,38,611,343,310,240,61,274,632,43.4,358,437,130,307,326,937,841,8,"https://fbref.com/en/squads/a0435291/2021-2022/Granada-Stats"
2022,"Granada","La Liga","opponent",32,38,546,279,268,193,85,225,495,45.5,270,359,106,253,307,853,662,11,"https://fbref.com/en/squads/a0435291/2021-2022/Granada-Stats"
2022,"Greuther Fürth","Bundesliga","team",29,34,568,336,258,252,58,270,567,47.6,297,416,124,292,374,942,712,8,"https://fbref.com/en/squads/12192a4c/2021-2022/Greuther-Furth-Stats"
2022,"Greuther Fürth","Bundesliga","opponent",29,34,578,325,266,251,61,270,536,50.4,266,368,82,286,312,890,549,7,"https://fbref.com/en/squads/12192a4c/2021-2022/Greuther-Furth-Stats"
2022,"Hellas Verona","Serie A","team",31,38,534,308,248,214,72,238,557,42.7,319,414,107,307,392,926,779,9,"https://fbref.com/en/squads/0e72edf2/2021-2022/Hellas-Verona-Stats"
2022,"Hellas Verona","Serie A","opponent",31,38,659,367,305,287,67,276,589,46.9,313,425,117,308,425,1084,569,16,"https://fbref.com/en/squads/0e72edf2/2021-2022/Hellas-Verona-Stats"
2022,"Hertha BSC","Bundesliga","team",36,34,546,321,294,197,55,252,544,46.3,292,377,105,272,406,952,816,15,"https://fbref.com/en/squads/2818f8bc/2021-2022/Hertha-BSC-Stats"
2022,"Hertha BSC","Bundesliga","opponent",36,34,561,333,215,269,77,245,526,46.6,281,372,75,297,352,913,526,11,"https://fbref.com/en/squads/2818f8bc/2021-2022/Hertha-BSC-Stats"
2022,"Hoffenheim","Bundesliga","team",32,34,483,291,191,216,76,223,484,46.1,261,390,88,302,285,768,520,17,"https://fbref.com/en/squads/033ea6b8/2021-2022/Hoffenheim-Stats"
2022,"Hoffenheim","Bundesliga","opponent",32,34,516,316,280,178,58,275,524,52.5,249,414,106,308,362,878,658,11,"https://fbref.com/en/squads/033ea6b8/2021-2022/Hoffenheim-Stats"
2022,"Inter","Serie A","team",27,38,588,332,265,240,83,247,545,45.3,298,360,110,250,332,920,485,11,"https://fbref.com/en/squads/d609edc0/2021-2022/Internazionale-Stats"
2022,"Inter","Serie A","opponent",27,38,461,251,230,172,59,216,471,45.9,255,447,172,275,395,856,832,8,"https://fbref.com/en/squads/d609edc0/2021-2022/Internazionale-Stats"
2022,"Juventus","Serie A","team",32,38,555,316,260,217,78,236,529,44.6,293,392,134,258,332,887,677,9,"https://fbref.com/en/squads/e0652b02/2021-2022/Juventus-Stats"
2022,"Juventus","Serie A","opponent",32,38,582,334,277,224,81,270,637,42.4,367,389,120,269,364,946,570,12,"https://fbref.com/en/squads/e0652b02/2021-2022/Juventus-Stats"
2022,"Köln","Bundesliga","team",26,34,598,361,264,246,88,288,665,43.3,377,442,99,343,426,1024,628,10,"https://fbref.com/en/squads/bc357bf7/2021-2022/Koln-Stats"
2022,"Köln","Bundesliga","opponent",26,34,514,324,218,228,68,256,508,50.4,252,395,95,300,367,881,880,9,"https://fbref.com/en/squads/bc357bf7/2021-2022/Koln-Stats"
2022,"Lazio","Serie A","team",27,38,578,339,246,255,77,238,621,38.3,383,416,144,272,315,893,565,10,"https://fbref.com/en/squads/7213da33/2021-2022/Lazio-Stats"
2022,"Lazio","Serie A","opponent",27,38,547,319,243,223,81,274,608,45.1,334,351,89,262,399,946,621,14,"https://fbref.com/en/squads/7213da33/2021-2022/Lazio-Stats"
2022,"Leeds United","Premier League","team",29,38,787,437,396,298,93,408,886,46,478,473,143,330,395,1182,621,15,"https://fbref.com/en/squads/5bfb9659/2021-2022/Leeds-United-Stats"
2022,"Leeds United","Premier League","opponent",29,38,614,351,282,248,84,316,655,48.2,339,459,138,321,398,1012,735,20,"https://fbref.com/en/squads/5bfb9659/2021-2022/Leeds-United-Stats"
2022,"Leicester City","Premier League","team",28,38,690,384,336,270,84,306,720,42.5,414,469,146,323,367,1057,777,15,"https://fbref.com/en/squads/a2d435b3/2021-2022/Leicester-City-Stats"
2022,"Leicester City","Premier League","opponent",28,38,618,370,262,264,92,250,547,45.7,297,455,117,338,400,1018,630,13,"https://fbref.com/en/squads/a2d435b3/2021-2022/Leicester-City-Stats"
2022,"Lens","Ligue 1","team",28,38,591,359,273,243,75,266,602,44.2,336,360,99,261,455,1046,616,7,"https://fbref.com/en/squads/fd4e0f7d/2021-2022/Lens-Stats"
2022,"Lens","Ligue 1","opponent",28,38,585,333,296,228,61,249,594,41.9,345,369,119,250,474,1059,613,17,"https://fbref.com/en/squads/fd4e0f7d/2021-2022/Lens-Stats"
2022,"Levante","La Liga","team",31,38,558,305,268,212,78,237,611,38.8,374,326,110,216,377,935,735,12,"https://fbref.com/en/squads/9800b6a1/2021-2022/Levante-Stats"
2022,"Levante","La Liga","opponent",31,38,637,384,345,238,54,335,683,49,348,379,107,272,327,964,621,17,"https://fbref.com/en/squads/9800b6a1/2021-2022/Levante-Stats"
2022,"Leverkusen","Bundesliga","team",29,34,484,281,235,199,50,225,493,45.6,268,350,101,249,360,844,620,12,"https://fbref.com/en/squads/c7a9f859/2021-2022/Bayer-Leverkusen-Stats"
2022,"Leverkusen","Bundesliga","opponent",29,34,601,347,272,246,83,305,706,43.2,401,395,95,300,414,1015,588,13,"https://fbref.com/en/squads/c7a9f859/2021-2022/Bayer-Leverkusen-Stats"
2022,"Lille","Ligue 1","team",26,38,653,359,310,274,69,305,619,49.3,314,351,111,240,377,1030,672,6,"https://fbref.com/en/squads/cb188c0c/2021-2022/Lille-Stats"
2022,"Lille","Ligue 1","opponent",26,38,653,395,321,262,70,306,619,49.4,313,410,101,309,437,1090,601,10,"https://fbref.com/en/squads/cb188c0c/2021-2022/Lille-Stats"
2022,"Liverpool","Premier League","team",27,38,554,320,207,240,107,233,576,40.5,343,359,74,285,340,894,523,8,"https://fbref.com/en/squads/822bd0ba/2021-2022/Liverpool-Stats"
2022,"Liverpool","Premier League","opponent",27,38,657,350,407,211,39,291,634,45.9,343,542,212,330,487,1144,999,18,"https://fbref.com/en/squads/822bd0ba/2021-2022/Liverpool-Stats"
2022,"Lorient","Ligue 1","team",29,38,696,412,337,292,67,383,811,47.2,428,405,115,290,412,1108,776,9,"https://fbref.com/en/squads/d2c87802/2021-2022/Lorient-Stats"
2022,"Lorient","Ligue 1","opponent",29,38,622,388,267,270,85,290,597,48.6,307,373,116,257,392,1014,540,9,"https://fbref.com/en/squads/d2c87802/2021-2022/Lorient-Stats"
2022,"Lyon","Ligue 1","team",30,38,632,367,264,270,98,279,614,45.4,335,385,91,294,396,1028,621,17,"https://fbref.com/en/squads/d53c0b06/2021-2022/Lyon-Stats"
2022,"Lyon","Ligue 1","opponent",30,38,733,403,382,279,72,325,814,39.9,489,435,147,288,485,1218,629,9,"https://fbref.com/en/squads/d53c0b06/2021-2022/Lyon-Stats"
2022,"M'Gladbach","Bundesliga","team",26,34,572,345,260,252,60,285,615,46.3,330,402,91,311,326,898,553,13,"https://fbref.com/en/squads/32f3ee20/2021-2022/Monchengladbach-Stats"
2022,"M'Gladbach","Bundesliga","opponent",26,34,560,321,247,260,53,251,610,41.1,359,434,134,300,364,924,499,12,"https://fbref.com/en/squads/32f3ee20/2021-2022/Monchengladbach-Stats"
2022,"Mainz 05","Bundesliga","team",28,34,579,305,291,220,68,282,595,47.4,313,404,94,310,439,1018,584,9,"https://fbref.com/en/squads/a224b06a/2021-2022/Mainz-05-Stats"
2022,"Mainz 05","Bundesliga","opponent",28,34,532,312,244,231,57,237,506,46.8,269,385,105,280,359,891,748,10,"https://fbref.com/en/squads/a224b06a/2021-2022/Mainz-05-Stats"
2022,"Mallorca","La Liga","team",33,38,607,332,301,235,71,248,551,45,303,374,119,255,344,951,826,9,"https://fbref.com/en/squads/2aa12281/2021-2022/Mallorca-Stats"
2022,"Mallorca","La Liga","opponent",33,38,648,351,257,304,87,244,612,39.9,368,377,121,256,306,954,746,10,"https://fbref.com/en/squads/2aa12281/2021-2022/Mallorca-Stats"
2022,"Manchester City","Premier League","team",26,38,498,284,183,214,101,227,509,44.6,282,267,55,212,279,777,403,7,"https://fbref.com/en/squads/b8fd03ef/2021-2022/Manchester-City-Stats"
2022,"Manchester City","Premier League","opponent",26,38,632,359,392,194,46,316,741,42.6,425,509,209,300,374,1006,909,24,"https://fbref.com/en/squads/b8fd03ef/2021-2022/Manchester-City-Stats"
2022,"Manchester Utd","Premier League","team",29,38,585,358,320,197,68,265,608,43.6,343,404,133,271,340,925,704,20,"https://fbref.com/en/squads/19538871/2021-2022/Manchester-United-Stats"
2022,"Manchester Utd","Premier League","opponent",29,38,596,347,273,228,95,263,631,41.7,368,468,143,325,430,1026,686,17,"https://fbref.com/en/squads/19538871/2021-2022/Manchester-United-Stats"
2022,"Marseille","Ligue 1","team",27,38,556,319,252,238,66,232,501,46.3,269,263,65,198,327,883,437,10,"https://fbref.com/en/squads/5725cc7b/2021-2022/Marseille-Stats"
2022,"Marseille","Ligue 1","opponent",27,38,594,351,307,210,77,266,573,46.4,307,414,127,287,404,998,610,5,"https://fbref.com/en/squads/5725cc7b/2021-2022/Marseille-Stats"
2022,"Metz","Ligue 1","team",36,38,711,442,395,275,41,300,649,46.2,349,452,139,313,507,1218,782,11,"https://fbref.com/en/squads/f83960ae/2021-2022/Metz-Stats"
2022,"Metz","Ligue 1","opponent",36,38,639,387,244,303,92,275,609,45.2,334,355,96,259,359,998,504,4,"https://fbref.com/en/squads/f83960ae/2021-2022/Metz-Stats"
2022,"Milan","Serie A","team",28,38,697,421,304,288,105,281,583,48.2,302,371,110,261,355,1052,477,12,"https://fbref.com/en/squads/dc56fe14/2021-2022/Milan-Stats"
2022,"Milan","Serie A","opponent",28,38,635,352,318,250,67,323,779,41.5,456,431,158,273,356,991,722,16,"https://fbref.com/en/squads/dc56fe14/2021-2022/Milan-Stats"
2022,"Monaco","Ligue 1","team",27,38,745,435,292,368,85,324,701,46.2,377,378,103,275,424,1169,487,10,"https://fbref.com/en/squads/fd6114db/2021-2022/Monaco-Stats"
2022,"Monaco","Ligue 1","opponent",27,38,607,360,308,246,53,286,652,43.9,366,407,113,294,506,1113,806,9,"https://fbref.com/en/squads/fd6114db/2021-2022/Monaco-Stats"
2022,"Montpellier","Ligue 1","team",26,38,625,380,340,210,75,309,723,42.7,414,363,134,229,356,981,675,13,"https://fbref.com/en/squads/281b0e73/2021-2022/Montpellier-Stats"
2022,"Montpellier","Ligue 1","opponent",26,38,614,384,266,246,102,274,590,46.4,316,376,120,256,411,1025,683,9,"https://fbref.com/en/squads/281b0e73/2021-2022/Montpellier-Stats"
2022,"Nantes","Ligue 1","team",26,38,685,405,331,262,92,353,774,45.6,421,419,136,283,415,1100,680,9,"https://fbref.com/en/squads/d7a486cd/2021-2022/Nantes-Stats"
2022,"Nantes","Ligue 1","opponent",26,38,695,409,386,233,76,343,676,50.7,333,319,93,226,357,1052,666,10,"https://fbref.com/en/squads/d7a486cd/2021-2022/Nantes-Stats"
2022,"Napoli","Serie A","team",27,38,550,327,246,227,77,268,617,43.4,349,371,108,263,296,846,510,8,"https://fbref.com/en/squads/d48ad4ff/2021-2022/Napoli-Stats"
2022,"Napoli","Serie A","opponent",27,38,532,320,248,220,64,238,595,40,357,455,155,300,397,929,613,19,"https://fbref.com/en/squads/d48ad4ff/2021-2022/Napoli-Stats"
2022,"Newcastle Utd","Premier League","team",29,38,659,383,334,266,59,304,641,47.4,337,420,162,258,360,1019,776,14,"https://fbref.com/en/squads/b2b47a98/2021-2022/Newcastle-United-Stats"
2022,"Newcastle Utd","Premier League","opponent",29,38,632,364,298,260,74,273,632,43.2,359,373,120,253,268,900,665,12,"https://fbref.com/en/squads/b2b47a98/2021-2022/Newcastle-United-Stats"
2022,"Nice","Ligue 1","team",27,38,610,369,291,253,66,314,590,53.2,276,392,119,273,441,1051,595,7,"https://fbref.com/en/squads/132ebc33/2021-2022/Nice-Stats"
2022,"Nice","Ligue 1","opponent",27,38,658,386,321,252,85,310,697,44.5,387,372,100,272,381,1039,677,9,"https://fbref.com/en/squads/132ebc33/2021-2022/Nice-Stats"
2022,"Norwich City","Premier League","team",28,38,614,368,322,242,50,297,714,41.6,417,450,180,270,381,995,860,14,"https://fbref.com/en/squads/1c781004/2021-2022/Norwich-City-Stats"
2022,"Norwich City","Premier League","opponent",28,38,596,363,273,234,89,283,581,48.7,298,382,115,267,330,926,586,13,"https://fbref.com/en/squads/1c781004/2021-2022/Norwich-City-Stats"
2022,"Osasuna","La Liga","team",29,38,577,331,270,236,71,251,598,42,347,340,115,225,368,945,758,5,"https://fbref.com/en/squads/03c57e2b/2021-2022/Osasuna-Stats"
2022,"Osasuna","La Liga","opponent",29,38,515,326,265,204,46,206,467,44.1,261,355,99,256,353,868,843,15,"https://fbref.com/en/squads/03c57e2b/2021-2022/Osasuna-Stats"
2022,"Paris S-G","Ligue 1","team",36,38,607,360,229,276,102,290,599,48.4,309,330,106,224,303,910,437,14,"https://fbref.com/en/squads/e2d8892c/2021-2022/Paris-Saint-Germain-Stats"
2022,"Paris S-G","Ligue 1","opponent",36,38,729,393,417,240,72,381,871,43.7,490,380,127,253,455,1184,571,8,"https://fbref.com/en/squads/e2d8892c/2021-2022/Paris-Saint-Germain-Stats"
2022,"RB Leipzig","Bundesliga","team",29,34,499,289,218,222,59,219,512,42.8,293,399,81,318,349,848,523,12,"https://fbref.com/en/squads/acbb6a5b/2021-2022/RB-Leipzig-Stats"
2022,"RB Leipzig","Bundesliga","opponent",29,34,569,318,272,231,66,213,560,38,347,389,96,293,402,971,569,11,"https://fbref.com/en/squads/acbb6a5b/2021-2022/RB-Leipzig-Stats"
2022,"Rayo Vallecano","La Liga","team",28,38,621,359,320,237,64,280,688,40.7,408,410,95,315,365,986,686,9,"https://fbref.com/en/squads/98e8af82/2021-2022/Rayo-Vallecano-Stats"
2022,"Rayo Vallecano","La Liga","opponent",28,38,653,391,304,274,75,282,639,44.1,357,400,130,270,343,996,711,15,"https://fbref.com/en/squads/98e8af82/2021-2022/Rayo-Vallecano-Stats"
2022,"Real Madrid","La Liga","team",31,38,560,345,281,195,84,211,502,42,291,379,114,265,334,894,526,17,"https://fbref.com/en/squads/53a2f082/2021-2022/Real-Madrid-Stats"
2022,"Real Madrid","La Liga","opponent",31,38,601,346,347,159,95,324,780,41.5,456,443,161,282,341,942,696,16,"https://fbref.com/en/squads/53a2f082/2021-2022/Real-Madrid-Stats"
2022,"Real Sociedad","La Liga","team",32,38,586,339,271,234,81,260,546,47.6,286,382,105,277,348,934,703,6,"https://fbref.com/en/squads/e31d1cd9/2021-2022/Real-Sociedad-Stats"
2022,"Real Sociedad","La Liga","opponent",32,38,701,415,344,276,81,310,670,46.3,360,424,117,307,339,1040,693,9,"https://fbref.com/en/squads/e31d1cd9/2021-2022/Real-Sociedad-Stats"
2022,"Reims","Ligue 1","team",35,38,615,365,328,221,66,286,629,45.5,343,460,154,306,493,1108,753,7,"https://fbref.com/en/squads/7fdd64e0/2021-2022/Reims-Stats"
2022,"Reims","Ligue 1","opponent",35,38,589,335,246,251,92,265,594,44.6,329,368,86,282,367,956,551,9,"https://fbref.com/en/squads/7fdd64e0/2021-2022/Reims-Stats"
2022,"Rennes","Ligue 1","team",28,38,546,318,234,215,97,261,550,47.5,289,347,92,255,315,861,646,12,"https://fbref.com/en/squads/b3072e00/2021-2022/Rennes-Stats"
2022,"Rennes","Ligue 1","opponent",28,38,512,295,240,212,60,243,530,45.8,287,396,137,259,392,904,665,11,"https://fbref.com/en/squads/b3072e00/2021-2022/Rennes-Stats"
2022,"Roma","Serie A","team",29,38,613,362,282,253,78,283,622,45.5,339,383,82,301,385,998,552,9,"https://fbref.com/en/squads/cf74a709/2021-2022/Roma-Stats"
2022,"Roma","Serie A","opponent",29,38,586,361,290,226,70,299,630,47.5,331,402,165,237,383,969,722,5,"https://fbref.com/en/squads/cf74a709/2021-2022/Roma-Stats"
2022,"Saint-Étienne","Ligue 1","team",39,38,695,397,341,265,89,295,638,46.2,343,398,93,305,452,1147,563,10,"https://fbref.com/en/squads/d298ef2c/2021-2022/Saint-Etienne-Stats"
2022,"Saint-Étienne","Ligue 1","opponent",39,38,737,415,316,321,100,339,736,46.1,397,380,105,275,402,1139,591,16,"https://fbref.com/en/squads/d298ef2c/2021-2022/Saint-Etienne-Stats"
2022,"Salernitana","Serie A","team",42,38,541,321,274,208,59,277,579,47.8,302,394,146,248,353,894,777,3,"https://fbref.com/en/squads/c5577084/2021-2022/Salernitana-Stats"
2022,"Salernitana","Serie A","opponent",42,38,602,341,267,244,91,272,586,46.4,314,373,114,259,315,917,702,12,"https://fbref.com/en/squads/c5577084/2021-2022/Salernitana-Stats"
2022,"Sampdoria","Serie A","team",34,38,562,327,277,217,68,288,629,45.8,341,383,134,249,443,1005,723,11,"https://fbref.com/en/squads/8ff9e3b3/2021-2022/Sampdoria-Stats"
2022,"Sampdoria","Serie A","opponent",34,38,464,276,177,196,91,194,422,46,228,410,108,302,363,827,631,7,"https://fbref.com/en/squads/8ff9e3b3/2021-2022/Sampdoria-Stats"
2022,"Sassuolo","Serie A","team",29,38,482,271,252,163,67,236,574,41.1,338,422,127,295,314,796,664,19,"https://fbref.com/en/squads/e2befd26/2021-2022/Sassuolo-Stats"
2022,"Sassuolo","Serie A","opponent",29,38,661,371,286,271,104,275,678,40.6,403,440,154,286,374,1035,573,12,"https://fbref.com/en/squads/e2befd26/2021-2022/Sassuolo-Stats"
2022,"Sevilla","La Liga","team",33,38,534,302,252,211,71,236,542,43.5,306,367,124,243,270,804,603,18,"https://fbref.com/en/squads/ad2be733/2021-2022/Sevilla-Stats"
2022,"Sevilla","La Liga","opponent",33,38,609,353,312,203,94,283,588,48.1,305,344,91,253,348,957,748,8,"https://fbref.com/en/squads/ad2be733/2021-2022/Sevilla-Stats"
2022,"Southampton","Premier League","team",25,38,602,340,285,243,74,248,581,42.7,333,430,132,298,446,1048,795,13,"https://fbref.com/en/squads/33c895d4/2021-2022/Southampton-Stats"
2022,"Southampton","Premier League","opponent",25,38,640,357,309,249,82,274,624,43.9,350,438,137,301,349,989,820,18,"https://fbref.com/en/squads/33c895d4/2021-2022/Southampton-Stats"
2022,"Spezia","Serie A","team",30,38,580,343,301,205,74,266,585,45.5,319,465,176,289,372,952,736,8,"https://fbref.com/en/squads/68449f6d/2021-2022/Spezia-Stats"
2022,"Spezia","Serie A","opponent",30,38,607,366,270,234,103,254,546,46.5,292,388,105,283,334,941,514,7,"https://fbref.com/en/squads/68449f6d/2021-2022/Spezia-Stats"
2022,"Strasbourg","Ligue 1","team",26,38,660,392,302,257,101,293,626,46.8,333,380,93,287,433,1093,563,6,"https://fbref.com/en/squads/c0d3eab4/2021-2022/Strasbourg-Stats"
2022,"Strasbourg","Ligue 1","opponent",26,38,526,284,269,199,58,226,498,45.4,272,348,99,249,406,932,771,19,"https://fbref.com/en/squads/c0d3eab4/2021-2022/Strasbourg-Stats"
2022,"Stuttgart","Bundesliga","team",34,34,532,307,231,236,65,241,530,45.5,289,386,124,262,342,874,708,8,"https://fbref.com/en/squads/598bc722/2021-2022/Stuttgart-Stats"
2022,"Stuttgart","Bundesliga","opponent",34,34,623,346,279,268,76,321,693,46.3,372,390,109,281,345,968,607,7,"https://fbref.com/en/squads/598bc722/2021-2022/Stuttgart-Stats"
2022,"Torino","Serie A","team",31,38,531,314,223,234,74,228,440,51.8,212,375,108,267,423,954,651,4,"https://fbref.com/en/squads/105360fe/2021-2022/Torino-Stats"
2022,"Torino","Serie A","opponent",31,38,502,284,267,190,45,216,511,42.3,295,390,123,267,300,802,625,9,"https://fbref.com/en/squads/105360fe/2021-2022/Torino-Stats"
2022,"Tottenham","Premier League","team",25,38,598,349,286,244,68,262,584,44.9,322,470,161,309,355,953,793,15,"https://fbref.com/en/squads/361ca564/2021-2022/Tottenham-Hotspur-Stats"
2022,"Tottenham","Premier League","opponent",25,38,632,369,278,267,87,291,666,43.7,375,419,135,284,368,1000,676,10,"https://fbref.com/en/squads/361ca564/2021-2022/Tottenham-Hotspur-Stats"
2022,"Troyes","Ligue 1","team",35,38,636,351,351,221,64,285,625,45.6,340,375,107,268,430,1066,656,8,"https://fbref.com/en/squads/54195385/2021-2022/Troyes-Stats"
2022,"Troyes","Ligue 1","opponent",35,38,590,356,257,256,77,268,586,45.7,318,361,79,282,379,969,597,4,"https://fbref.com/en/squads/54195385/2021-2022/Troyes-Stats"
2022,"Udinese","Serie A","team",29,38,622,350,282,271,69,284,643,44.2,359,432,122,310,351,973,671,12,"https://fbref.com/en/squads/04eea015/2021-2022/Udinese-Stats"
2022,"Udinese","Serie A","opponent",29,38,650,363,301,254,95,316,679,46.5,363,390,126,264,340,990,611,9,"https://fbref.com/en/squads/04eea015/2021-2022/Udinese-Stats"
2022,"Union Berlin","Bundesliga","team",28,34,538,296,266,223,49,268,568,47.2,300,322,90,232,376,914,657,7,"https://fbref.com/en/squads/7a41008f/2021-2022/Union-Berlin-Stats"
2022,"Union Berlin","Bundesliga","opponent",28,34,399,227,186,163,50,168,412,40.8,244,350,71,279,354,753,641,15,"https://fbref.com/en/squads/7a41008f/2021-2022/Union-Berlin-Stats"
2022,"Valencia","La Liga","team",34,38,591,363,289,217,85,266,623,42.7,357,373,93,280,338,929,746,8,"https://fbref.com/en/squads/dcc91a7b/2021-2022/Valencia-Stats"
2022,"Valencia","La Liga","opponent",34,38,576,335,299,211,66,282,642,43.9,360,314,90,224,286,862,795,7,"https://fbref.com/en/squads/dcc91a7b/2021-2022/Valencia-Stats"
2022,"Venezia","Serie A","team",39,38,613,352,325,217,71,273,626,43.6,353,495,202,293,388,1001,865,13,"https://fbref.com/en/squads/af5d5982/2021-2022/Venezia-Stats"
2022,"Venezia","Serie A","opponent",39,38,589,341,251,246,92,276,576,47.9,300,377,82,295,370,959,560,5,"https://fbref.com/en/squads/af5d5982/2021-2022/Venezia-Stats"
2022,"Villarreal","La Liga","team",29,38,538,312,250,197,91,229,476,48.1,247,330,109,221,329,867,644,16,"https://fbref.com/en/squads/2a8183b3/2021-2022/Villarreal-Stats"
2022,"Villarreal","La Liga","opponent",29,38,628,380,310,234,84,296,746,39.7,450,469,112,357,387,1015,690,11,"https://fbref.com/en/squads/2a8183b3/2021-2022/Villarreal-Stats"
2022,"Watford","Premier League","team",30,38,614,356,341,213,60,278,626,44.4,348,440,148,292,444,1058,899,19,"https://fbref.com/en/squads/2abfe087/2021-2022/Watford-Stats"
2022,"Watford","Premier League","opponent",30,38,745,438,356,287,102,356,751,47.4,395,377,93,284,347,1092,608,15,"https://fbref.com/en/squads/2abfe087/2021-2022/Watford-Stats"
2022,"West Ham","Premier League","team",25,38,534,301,273,199,62,240,557,43.1,317,420,175,245,374,908,781,5,"https://fbref.com/en/squads/7c21e445/2021-2022/West-Ham-United-Stats"
2022,"West Ham","Premier League","opponent",25,38,533,324,284,184,65,239,545,43.9,306,408,133,275,337,870,776,9,"https://fbref.com/en/squads/7c21e445/2021-2022/West-Ham-United-Stats"
2022,"Wolfsburg","Bundesliga","team",30,34,539,298,278,201,60,257,540,47.6,283,388,103,285,388,927,740,9,"https://fbref.com/en/squads/4eaa11d7/2021-2022/Wolfsburg-Stats"
2022,"Wolfsburg","Bundesliga","opponent",30,34,506,282,207,228,71,222,541,41,319,356,94,262,349,855,583,10,"https://fbref.com/en/squads/4eaa11d7/2021-2022/Wolfsburg-Stats"
2022,"Wolves","Premier League","team",26,38,673,377,377,242,54,273,671,40.7,398,437,135,302,389,1062,820,20,"https://fbref.com/en/squads/8cec06e1/2021-2022/Wolverhampton-Wanderers-Stats"
2022,"Wolves","Premier League","opponent",26,38,662,388,297,277,88,321,771,41.6,450,404,108,296,383,1045,630,14,"https://fbref.com/en/squads/8cec06e1/2021-2022/Wolverhampton-Wanderers-Stats"
2023,"Ajaccio","Ligue 1","team",36,38,637,382,321,236,80,313,693,45.2,380,359,85,274,420,1057,670,10,"https://fbref.com/en/squads/7a54bb4f/2022-2023/Ajaccio-Stats"
2023,"Ajaccio","Ligue 1","opponent",36,38,601,366,264,267,70,277,560,49.5,283,386,77,309,349,950,613,5,"https://fbref.com/en/squads/7a54bb4f/2022-2023/Ajaccio-Stats"
2023,"Almería","La Liga","team",29,38,557,322,292,202,63,280,623,44.9,343,435,122,313,322,879,855,13,"https://fbref.com/en/squads/78ecf4bb/2022-2023/Almeria-Stats"
2023,"Almería","La Liga","opponent",29,38,591,369,274,233,84,310,605,51.2,295,373,108,265,249,840,553,14,"https://fbref.com/en/squads/78ecf4bb/2022-2023/Almeria-Stats"
2023,"Angers","Ligue 1","team",33,38,652,386,311,268,73,310,610,50.8,300,402,99,303,375,1027,605,13,"https://fbref.com/en/squads/69236f98/2022-2023/Angers-Stats"
2023,"Angers","Ligue 1","opponent",33,38,741,450,348,293,100,392,833,47.1,441,347,84,263,370,1111,526,11,"https://fbref.com/en/squads/69236f98/2022-2023/Angers-Stats"
2023,"Arsenal","Premier League","team",26,38,568,343,238,212,118,249,509,48.9,260,362,86,276,237,805,599,23,"https://fbref.com/en/squads/18bb7c10/2022-2023/Arsenal-Stats"
2023,"Arsenal","Premier League","opponent",26,38,668,387,402,202,64,290,641,45.2,351,516,186,330,360,1028,841,21,"https://fbref.com/en/squads/18bb7c10/2022-2023/Arsenal-Stats"
2023,"Aston Villa","Premier League","team",26,38,633,338,305,251,77,313,646,48.5,333,438,118,320,324,957,714,14,"https://fbref.com/en/squads/8602292d/2022-2023/Aston-Villa-Stats"
2023,"Aston Villa","Premier League","opponent",26,38,650,370,305,237,108,279,571,48.9,292,413,127,286,332,982,635,10,"https://fbref.com/en/squads/8602292d/2022-2023/Aston-Villa-Stats"
2023,"Atalanta","Serie A","team",27,38,636,364,291,272,73,312,634,49.2,322,455,93,362,421,1057,613,12,"https://fbref.com/en/squads/922493f3/2022-2023/Atalanta-Stats"
2023,"Atalanta","Serie A","opponent",27,38,742,458,420,245,77,355,695,51.1,340,454,133,321,360,1102,704,9,"https://fbref.com/en/squads/922493f3/2022-2023/Atalanta-Stats"
2023,"Athletic Club","La Liga","team",26,38,608,369,267,254,87,322,642,50.2,320,415,95,320,310,918,598,14,"https://fbref.com/en/squads/2b390eca/2022-2023/Athletic-Club-Stats"
2023,"Athletic Club","La Liga","opponent",26,38,656,417,374,212,70,305,652,46.8,347,449,147,302,384,1040,839,17,"https://fbref.com/en/squads/2b390eca/2022-2023/Athletic-Club-Stats"
2023,"Atlético Madrid","La Liga","team",27,38,667,408,332,245,90,334,685,48.8,351,396,103,293,304,971,704,9,"https://fbref.com/en/squads/db3b9613/2022-2023/Atletico-Madrid-Stats"
2023,"Atlético Madrid","La Liga","opponent",27,38,539,317,271,181,87,262,584,44.9,322,445,134,311,368,907,663,14,"https://fbref.com/en/squads/db3b9613/2022-2023/Atletico-Madrid-Stats"
2023,"Augsburg","Bundesliga","team",34,34,522,299,251,202,69,232,479,48.4,247,429,126,303,286,808,755,14,"https://fbref.com/en/squads/0cdc4311/2022-2023/Augsburg-Stats"
2023,"Augsburg","Bundesliga","opponent",34,34,500,302,231,200,69,234,435,53.8,201,387,99,288,262,762,701,7,"https://fbref.com/en/squads/0cdc4311/2022-2023/Augsburg-Stats"
2023,"Auxerre","Ligue 1","team",33,38,674,378,337,263,74,313,678,46.2,365,441,118,323,454,1128,782,11,"https://fbref.com/en/squads/5ae09109/2022-2023/Auxerre-Stats"
2023,"Auxerre","Ligue 1","opponent",33,38,639,393,276,267,96,319,656,48.6,337,379,98,281,361,1000,584,8,"https://fbref.com/en/squads/5ae09109/2022-2023/Auxerre-Stats"
2023,"Barcelona","La Liga","team",29,38,522,324,211,216,95,227,496,45.8,269,353,82,271,253,775,439,17,"https://fbref.com/en/squads/206d90db/2022-2023/Barcelona-Stats"
2023,"Barcelona","La Liga","opponent",29,38,647,385,332,250,65,321,717,44.8,396,423,139,284,369,1016,746,17,"https://fbref.com/en/squads/206d90db/2022-2023/Barcelona-Stats"
2023,"Bayern Munich","Bundesliga","team",28,34,623,387,263,258,102,287,538,53.3,251,381,77,304,287,910,477,19,"https://fbref.com/en/squads/054efa67/2022-2023/Bayern-Munich-Stats"
2023,"Bayern Munich","Bundesliga","opponent",28,34,716,417,342,301,73,362,828,43.7,466,442,159,283,414,1130,711,12,"https://fbref.com/en/squads/054efa67/2022-2023/Bayern-Munich-Stats"
2023,"Betis","La Liga","team",30,38,665,421,373,238,54,338,701,48.2,363,411,112,299,364,1029,857,7,"https://fbref.com/en/squads/fc536746/2022-2023/Real-Betis-Stats"
2023,"Betis","La Liga","opponent",30,38,664,417,303,268,93,311,676,46,365,437,95,342,325,989,584,9,"https://fbref.com/en/squads/fc536746/2022-2023/Real-Betis-Stats"
2023,"Bochum","Bundesliga","team",26,34,626,386,301,247,78,310,635,48.8,325,402,118,284,337,963,776,13,"https://fbref.com/en/squads/b42c6323/2022-2023/Bochum-Stats"
2023,"Bochum","Bundesliga","opponent",26,34,453,286,213,180,60,195,370,52.7,175,346,102,244,282,735,739,8,"https://fbref.com/en/squads/b42c6323/2022-2023/Bochum-Stats"
2023,"Bologna","Serie A","team",27,38,648,373,310,255,83,297,618,48.1,321,414,131,283,302,950,652,7,"https://fbref.com/en/squads/1d8099f8/2022-2023/Bologna-Stats"
2023,"Bologna","Serie A","opponent",27,38,548,325,255,220,73,243,508,47.8,265,455,117,338,320,868,571,10,"https://fbref.com/en/squads/1d8099f8/2022-2023/Bologna-Stats"
2023,"Bournemouth","Premier League","team",31,38,618,371,316,249,53,256,606,42.2,350,499,170,329,353,971,1027,11,"https://fbref.com/en/squads/4ba7cbea/2022-2023/Bournemouth-Stats"
2023,"Bournemouth","Premier League","opponent",31,38,711,426,318,271,122,344,665,51.7,321,404,96,308,279,990,563,13,"https://fbref.com/en/squads/4ba7cbea/2022-2023/Bournemouth-Stats"
2023,"Brentford","Premier League","team",25,38,587,337,270,228,89,253,599,42.2,346,456,168,288,341,928,822,14,"https://fbref.com/en/squads/cd051869/2022-2023/Brentford-Stats"
2023,"Brentford","Premier League","opponent",25,38,583,330,275,221,87,248,512,48.4,264,354,86,268,291,874,822,11,"https://fbref.com/en/squads/cd051869/2022-2023/Brentford-Stats"
2023,"Brest","Ligue 1","team",29,38,705,417,348,289,68,356,740,48.1,384,435,115,320,475,1180,686,13,"https://fbref.com/en/squads/fb08dbb3/2022-2023/Brest-Stats"
2023,"Brest","Ligue 1","opponent",29,38,623,370,307,234,82,301,571,52.7,270,396,95,301,368,991,655,11,"https://fbref.com/en/squads/fb08dbb3/2022-2023/Brest-Stats"
2023,"Brighton","Premier League","team",29,38,616,340,270,242,104,266,561,47.4,295,392,104,288,303,919,432,15,"https://fbref.com/en/squads/d07537b9/2022-2023/Brighton-and-Hove-Albion-Stats"
2023,"Brighton","Premier League","opponent",29,38,603,350,312,220,71,279,624,44.7,345,505,160,345,417,1020,777,25,"https://fbref.com/en/squads/d07537b9/2022-2023/Brighton-and-Hove-Albion-Stats"
2023,"Celta Vigo","La Liga","team",26,38,664,413,319,269,76,295,676,43.6,381,393,84,309,368,1032,666,5,"https://fbref.com/en/squads/f25da7fb/2022-2023/Celta-Vigo-Stats"
2023,"Celta Vigo","La Liga","opponent",26,38,593,356,314,204,75,295,618,47.7,323,369,121,248,394,987,681,9,"https://fbref.com/en/squads/f25da7fb/2022-2023/Celta-Vigo-Stats"
2023,"Chelsea","Premier League","team",32,38,740,445,363,267,110,333,656,50.8,323,466,108,358,341,1081,661,21,"https://fbref.com/en/squads/cff3d9bb/2022-2023/Chelsea-Stats"
2023,"Chelsea","Premier League","opponent",32,38,733,429,373,260,100,352,732,48.1,380,474,145,329,374,1107,792,10,"https://fbref.com/en/squads/cff3d9bb/2022-2023/Chelsea-Stats"
2023,"Clermont Foot","Ligue 1","team",28,38,685,398,350,250,85,351,779,45.1,428,424,126,298,440,1125,571,17,"https://fbref.com/en/squads/d9676424/2022-2023/Clermont-Foot-Stats"
2023,"Clermont Foot","Ligue 1","opponent",28,38,647,366,237,295,115,309,659,46.9,350,432,97,335,432,1079,548,12,"https://fbref.com/en/squads/d9676424/2022-2023/Clermont-Foot-Stats"
2023,"Cremonese","Serie A","team",33,38,704,400,403,228,73,364,729,49.9,365,432,136,296,393,1097,771,13,"https://fbref.com/en/squads/9aad3a77/2022-2023/Cremonese-Stats"
2023,"Cremonese","Serie A","opponent",33,38,548,331,253,216,79,251,488,51.4,237,384,120,264,307,855,706,13,"https://fbref.com/en/squads/9aad3a77/2022-2023/Cremonese-Stats"
2023,"Crystal Palace","Premier League","team",26,38,690,421,354,246,90,281,532,52.8,251,463,119,344,359,1049,807,7,"https://fbref.com/en/squads/47c64c55/2022-2023/Crystal-Palace-Stats"
2023,"Crystal Palace","Premier League","opponent",26,38,771,436,370,299,102,314,681,46.1,367,449,136,313,366,1137,659,13,"https://fbref.com/en/squads/47c64c55/2022-2023/Crystal-Palace-Stats"
2023,"Cádiz","La Liga","team",38,38,623,410,358,205,60,320,671,47.7,351,425,128,297,270,893,853,13,"https://fbref.com/en/squads/ee7c297c/2022-2023/Cadiz-Stats"
2023,"Cádiz","La Liga","opponent",38,38,603,374,255,249,99,249,495,50.3,246,347,87,260,242,845,727,10,"https://fbref.com/en/squads/ee7c297c/2022-2023/Cadiz-Stats"
2023,"Dortmund","Bundesliga","team",30,34,580,334,246,241,93,287,551,52.1,264,382,95,287,298,878,491,9,"https://fbref.com/en/squads/add600ae/2022-2023/Dortmund-Stats"
2023,"Dortmund","Bundesliga","opponent",30,34,722,439,367,277,78,366,781,46.9,415,462,124,338,339,1061,727,11,"https://fbref.com/en/squads/add600ae/2022-2023/Dortmund-Stats"
2023,"Eint Frankfurt","Bundesliga","team",28,34,562,357,244,248,70,265,585,45.3,320,415,88,327,284,846,687,5,"https://fbref.com/en/squads/f0ac8ee6/2022-2023/Eintracht-Frankfurt-Stats"
2023,"Eint Frankfurt","Bundesliga","opponent",28,34,624,360,311,242,71,331,623,53.1,292,432,101,331,377,1001,734,9,"https://fbref.com/en/squads/f0ac8ee6/2022-2023/Eintracht-Frankfurt-Stats"
2023,"Elche","La Liga","team",32,38,633,363,367,212,54,280,603,46.4,323,413,131,282,323,956,766,13,"https://fbref.com/en/squads/6c8b07df/2022-2023/Elche-Stats"
2023,"Elche","La Liga","opponent",32,38,656,402,293,265,98,311,653,47.6,342,418,97,321,288,944,698,9,"https://fbref.com/en/squads/6c8b07df/2022-2023/Elche-Stats"
2023,"Empoli","Serie A","team",32,38,606,364,316,218,72,254,538,47.2,284,449,183,266,280,886,910,4,"https://fbref.com/en/squads/a3d88bd8/2022-2023/Empoli-Stats"
2023,"Empoli","Serie A","opponent",32,38,683,387,316,265,102,311,624,49.8,313,457,130,327,330,1013,632,8,"https://fbref.com/en/squads/a3d88bd8/2022-2023/Empoli-Stats"
2023,"Espanyol","La Liga","team",33,38,652,379,330,239,83,301,600,50.2,299,416,134,282,338,990,788,9,"https://fbref.com/en/squads/a8661628/2022-2023/Espanyol-Stats"
2023,"Espanyol","La Liga","opponent",33,38,505,326,239,220,46,260,517,50.3,257,328,100,228,238,743,822,10,"https://fbref.com/en/squads/a8661628/2022-2023/Espanyol-Stats"
2023,"Everton","Premier League","team",28,38,708,424,362,257,89,309,611,50.6,302,510,180,330,390,1098,874,17,"https://fbref.com/en/squads/d3fd31cc/2022-2023/Everton-Stats"
2023,"Everton","Premier League","opponent",28,38,596,365,270,258,68,296,601,49.3,305,384,122,262,275,871,727,14,"https://fbref.com/en/squads/d3fd31cc/2022-2023/Everton-Stats"
2023,"Fiorentina","Serie A","team",30,38,581,337,232,260,89,282,531,53.1,249,356,84,272,260,841,473,11,"https://fbref.com/en/squads/421387cf/2022-2023/Fiorentina-Stats"
2023,"Fiorentina","Serie A","opponent",30,38,618,339,338,227,53,273,596,45.8,323,448,176,272,331,949,844,12,"https://fbref.com/en/squads/421387cf/2022-2023/Fiorentina-Stats"
2023,"Freiburg","Bundesliga","team",27,34,498,289,223,211,64,207,450,46,243,375,106,269,325,823,612,10,"https://fbref.com/en/squads/a486e511/2022-2023/Freiburg-Stats"
2023,"Freiburg","Bundesliga","opponent",27,34,440,243,217,168,55,200,415,48.2,215,364,98,266,287,727,679,11,"https://fbref.com/en/squads/a486e511/2022-2023/Freiburg-Stats"
2023,"Fulham","Premier League","team",29,38,625,350,295,229,101,299,585,51.1,286,455,125,330,340,965,749,15,"https://fbref.com/en/squads/fd962109/2022-2023/Fulham-Stats"
2023,"Fulham","Premier League","opponent",29,38,618,363,281,258,79,239,511,46.8,272,447,116,331,340,958,754,9,"https://fbref.com/en/squads/fd962109/2022-2023/Fulham-Stats"
2023,"Getafe","La Liga","team",25,38,541,339,282,199,60,285,619,46,334,404,113,291,320,861,794,10,"https://fbref.com/en/squads/7848bd64/2022-2023/Getafe-Stats"
2023,"Getafe","La Liga","opponent",25,38,457,290,211,190,56,189,406,46.6,217,378,95,283,300,757,723,14,"https://fbref.com/en/squads/7848bd64/2022-2023/Getafe-Stats"
2023,"Girona","La Liga","team",29,38,551,321,271,213,67,244,532,45.9,288,379,111,268,266,817,662,20,"https://fbref.com/en/squads/9024a00a/2022-2023/Girona-Stats"
2023,"Girona","La Liga","opponent",29,38,641,415,289,265,87,311,652,47.7,341,359,78,281,303,944,659,10,"https://fbref.com/en/squads/9024a00a/2022-2023/Girona-Stats"
2023,"Hellas Verona","Serie A","team",36,38,605,357,319,228,58,296,562,52.7,266,445,143,302,337,942,745,12,"https://fbref.com/en/squads/0e72edf2/2022-2023/Hellas-Verona-Stats"
2023,"Hellas Verona","Serie A","opponent",36,38,604,346,304,231,69,275,549,50.1,274,378,105,273,272,876,694,4,"https://fbref.com/en/squads/0e72edf2/2022-2023/Hellas-Verona-Stats"
2023,"Hertha BSC","Bundesliga","team",32,34,576,344,307,215,54,251,521,48.2,270,416,132,284,366,942,797,8,"https://fbref.com/en/squads/2818f8bc/2022-2023/Hertha-BSC-Stats"
2023,"Hertha BSC","Bundesliga","opponent",32,34,617,384,272,278,67,316,639,49.5,323,350,93,257,299,916,645,9,"https://fbref.com/en/squads/2818f8bc/2022-2023/Hertha-BSC-Stats"
2023,"Hoffenheim","Bundesliga","team",31,34,543,323,254,231,58,236,474,49.8,238,428,119,309,285,828,665,8,"https://fbref.com/en/squads/033ea6b8/2022-2023/Hoffenheim-Stats"
2023,"Hoffenheim","Bundesliga","opponent",31,34,526,316,281,189,56,268,517,51.8,249,386,98,288,314,840,606,8,"https://fbref.com/en/squads/033ea6b8/2022-2023/Hoffenheim-Stats"
2023,"Inter","Serie A","team",25,38,572,325,247,241,84,258,523,49.3,265,385,110,275,315,887,541,7,"https://fbref.com/en/squads/d609edc0/2022-2023/Internazionale-Stats"
2023,"Inter","Serie A","opponent",25,38,461,262,213,183,65,200,416,48.1,216,373,149,224,330,791,802,10,"https://fbref.com/en/squads/d609edc0/2022-2023/Internazionale-Stats"
2023,"Juventus","Serie A","team",29,38,594,352,296,219,79,288,558,51.6,270,421,131,290,307,901,704,10,"https://fbref.com/en/squads/e0652b02/2022-2023/Juventus-Stats"
2023,"Juventus","Serie A","opponent",29,38,605,349,281,238,86,255,546,46.7,291,387,132,255,362,967,702,9,"https://fbref.com/en/squads/e0652b02/2022-2023/Juventus-Stats"
2023,"Köln","Bundesliga","team",27,34,615,370,287,263,65,310,666,46.5,356,423,99,324,372,987,716,5,"https://fbref.com/en/squads/bc357bf7/2022-2023/Koln-Stats"
2023,"Köln","Bundesliga","opponent",27,34,523,305,242,228,53,236,462,51.1,226,447,114,333,287,810,786,6,"https://fbref.com/en/squads/bc357bf7/2022-2023/Koln-Stats"
2023,"Lazio","Serie A","team",24,38,582,349,261,234,87,277,625,44.3,348,437,126,311,310,892,606,8,"https://fbref.com/en/squads/7213da33/2022-2023/Lazio-Stats"
2023,"Lazio","Serie A","opponent",24,38,529,301,219,242,68,239,524,45.6,285,405,107,298,329,858,537,15,"https://fbref.com/en/squads/7213da33/2022-2023/Lazio-Stats"
2023,"Lecce","Serie A","team",29,38,705,427,347,259,99,319,619,51.5,300,486,112,374,368,1073,826,4,"https://fbref.com/en/squads/ffcbe334/2022-2023/Lecce-Stats"
2023,"Lecce","Serie A","opponent",29,38,574,327,305,211,58,245,485,50.5,240,374,117,257,306,880,691,7,"https://fbref.com/en/squads/ffcbe334/2022-2023/Lecce-Stats"
2023,"Leeds United","Premier League","team",29,38,840,480,376,343,121,412,863,47.7,451,536,131,405,392,1232,734,18,"https://fbref.com/en/squads/5bfb9659/2022-2023/Leeds-United-Stats"
2023,"Leeds United","Premier League","opponent",29,38,749,427,379,292,78,328,596,55,268,509,140,369,391,1140,740,13,"https://fbref.com/en/squads/5bfb9659/2022-2023/Leeds-United-Stats"
2023,"Leicester City","Premier League","team",28,38,700,412,345,292,63,308,669,46,361,517,170,347,367,1067,777,12,"https://fbref.com/en/squads/a2d435b3/2022-2023/Leicester-City-Stats"
2023,"Leicester City","Premier League","opponent",28,38,558,336,263,217,78,245,536,45.7,291,475,112,363,339,897,600,16,"https://fbref.com/en/squads/a2d435b3/2022-2023/Leicester-City-Stats"
2023,"Lens","Ligue 1","team",29,38,540,323,225,238,77,262,570,46,308,401,112,289,339,879,559,7,"https://fbref.com/en/squads/fd4e0f7d/2022-2023/Lens-Stats"
2023,"Lens","Ligue 1","opponent",29,38,557,315,255,220,82,255,581,43.9,326,376,106,270,409,966,746,16,"https://fbref.com/en/squads/fd4e0f7d/2022-2023/Lens-Stats"
2023,"Leverkusen","Bundesliga","team",27,34,494,280,242,206,46,236,421,56.1,185,358,99,259,294,788,599,12,"https://fbref.com/en/squads/c7a9f859/2022-2023/Bayer-Leverkusen-Stats"
2023,"Leverkusen","Bundesliga","opponent",27,34,595,326,232,263,100,268,620,43.2,352,388,109,279,334,929,527,7,"https://fbref.com/en/squads/c7a9f859/2022-2023/Bayer-Leverkusen-Stats"
2023,"Lille","Ligue 1","team",26,38,635,370,266,265,104,314,658,47.7,344,390,74,316,301,936,543,13,"https://fbref.com/en/squads/cb188c0c/2022-2023/Lille-Stats"
2023,"Lille","Ligue 1","opponent",26,38,728,414,368,279,81,330,730,45.2,400,499,144,355,404,1132,682,14,"https://fbref.com/en/squads/cb188c0c/2022-2023/Lille-Stats"
2023,"Liverpool","Premier League","team",28,38,590,370,228,250,112,281,648,43.4,367,350,74,276,333,923,568,20,"https://fbref.com/en/squads/822bd0ba/2022-2023/Liverpool-Stats"
2023,"Liverpool","Premier League","opponent",28,38,694,391,368,254,72,282,602,46.8,320,501,164,337,410,1104,995,23,"https://fbref.com/en/squads/822bd0ba/2022-2023/Liverpool-Stats"
2023,"Lorient","Ligue 1","team",30,38,736,420,409,244,83,315,690,45.7,375,484,141,343,369,1105,849,17,"https://fbref.com/en/squads/d2c87802/2022-2023/Lorient-Stats"
2023,"Lorient","Ligue 1","opponent",30,38,720,433,329,272,119,388,794,48.9,406,425,115,310,395,1115,518,12,"https://fbref.com/en/squads/d2c87802/2022-2023/Lorient-Stats"
2023,"Lyon","Ligue 1","team",29,38,723,423,306,282,135,367,771,47.6,404,433,107,326,481,1204,542,12,"https://fbref.com/en/squads/d53c0b06/2022-2023/Lyon-Stats"
2023,"Lyon","Ligue 1","opponent",29,38,772,438,409,276,87,401,799,50.2,398,500,146,354,482,1254,738,15,"https://fbref.com/en/squads/d53c0b06/2022-2023/Lyon-Stats"
2023,"M'Gladbach","Bundesliga","team",27,34,497,275,274,171,52,267,536,49.8,269,405,104,301,267,764,728,7,"https://fbref.com/en/squads/32f3ee20/2022-2023/Monchengladbach-Stats"
2023,"M'Gladbach","Bundesliga","opponent",27,34,530,316,198,249,83,226,466,48.5,240,444,89,355,336,866,487,13,"https://fbref.com/en/squads/32f3ee20/2022-2023/Monchengladbach-Stats"
2023,"Mainz 05","Bundesliga","team",27,34,547,341,268,206,73,270,559,48.3,289,419,98,321,433,980,673,9,"https://fbref.com/en/squads/a224b06a/2022-2023/Mainz-05-Stats"
2023,"Mainz 05","Bundesliga","opponent",27,34,471,298,228,189,54,220,444,49.5,224,411,102,309,296,767,789,17,"https://fbref.com/en/squads/a224b06a/2022-2023/Mainz-05-Stats"
2023,"Mallorca","La Liga","team",31,38,583,344,318,213,52,283,581,48.7,298,402,146,256,318,901,859,7,"https://fbref.com/en/squads/2aa12281/2022-2023/Mallorca-Stats"
2023,"Mallorca","La Liga","opponent",31,38,500,296,202,217,81,198,491,40.3,293,333,82,251,231,731,621,8,"https://fbref.com/en/squads/2aa12281/2022-2023/Mallorca-Stats"
2023,"Manchester City","Premier League","team",24,38,471,272,185,198,88,212,462,45.9,250,339,95,244,223,694,402,9,"https://fbref.com/en/squads/b8fd03ef/2022-2023/Manchester-City-Stats"
2023,"Manchester City","Premier League","opponent",24,38,537,298,305,183,49,239,575,41.6,336,457,163,294,327,864,818,17,"https://fbref.com/en/squads/b8fd03ef/2022-2023/Manchester-City-Stats"
2023,"Manchester Utd","Premier League","team",26,38,658,400,343,231,84,301,598,50.3,297,496,146,350,352,1010,771,11,"https://fbref.com/en/squads/19538871/2022-2023/Manchester-United-Stats"
2023,"Manchester Utd","Premier League","opponent",26,38,631,361,312,226,93,338,655,51.6,317,554,165,389,415,1046,616,14,"https://fbref.com/en/squads/19538871/2022-2023/Manchester-United-Stats"
2023,"Marseille","Ligue 1","team",30,38,685,404,271,304,110,301,591,50.9,290,366,101,265,420,1105,570,11,"https://fbref.com/en/squads/5725cc7b/2022-2023/Marseille-Stats"
2023,"Marseille","Ligue 1","opponent",30,38,680,389,352,258,70,320,676,47.3,356,460,150,310,454,1134,734,12,"https://fbref.com/en/squads/5725cc7b/2022-2023/Marseille-Stats"
2023,"Milan","Serie A","team",30,38,690,422,327,295,68,300,563,53.3,263,387,126,261,289,979,542,9,"https://fbref.com/en/squads/dc56fe14/2022-2023/Milan-Stats"
2023,"Milan","Serie A","opponent",30,38,644,381,345,235,64,324,692,46.8,368,421,140,281,335,979,788,13,"https://fbref.com/en/squads/dc56fe14/2022-2023/Milan-Stats"
2023,"Monaco","Ligue 1","team",27,38,696,400,284,310,102,323,701,46.1,378,459,120,339,426,1122,549,14,"https://fbref.com/en/squads/fd6114db/2022-2023/Monaco-Stats"
2023,"Monaco","Ligue 1","opponent",27,38,628,353,302,250,76,283,601,47.1,318,415,100,315,434,1062,707,13,"https://fbref.com/en/squads/fd6114db/2022-2023/Monaco-Stats"
2023,"Montpellier","Ligue 1","team",31,38,684,413,362,249,73,361,745,48.5,384,448,121,327,404,1088,686,9,"https://fbref.com/en/squads/281b0e73/2022-2023/Montpellier-Stats"
2023,"Montpellier","Ligue 1","opponent",31,38,683,400,330,260,93,321,659,48.7,338,368,104,264,411,1094,684,13,"https://fbref.com/en/squads/281b0e73/2022-2023/Montpellier-Stats"
2023,"Monza","Serie A","team",31,38,595,355,323,214,58,260,551,47.2,291,380,120,260,334,929,661,13,"https://fbref.com/en/squads/21680aa4/2022-2023/Monza-Stats"
2023,"Monza","Serie A","opponent",31,38,546,323,222,235,89,237,519,45.7,282,377,105,272,316,862,555,6,"https://fbref.com/en/squads/21680aa4/2022-2023/Monza-Stats"
2023,"Nantes","Ligue 1","team",29,38,709,431,367,249,93,367,730,50.3,363,427,107,320,431,1140,731,8,"https://fbref.com/en/squads/d7a486cd/2022-2023/Nantes-Stats"
2023,"Nantes","Ligue 1","opponent",29,38,683,415,367,245,71,333,711,46.8,378,372,109,263,336,1019,738,13,"https://fbref.com/en/squads/d7a486cd/2022-2023/Nantes-Stats"
2023,"Napoli","Serie A","team",27,38,569,313,236,227,106,255,521,48.9,266,374,96,278,287,856,490,7,"https://fbref.com/en/squads/d48ad4ff/2022-2023/Napoli-Stats"
2023,"Napoli","Serie A","opponent",27,38,700,406,403,226,71,361,698,51.7,337,436,161,275,331,1031,726,14,"https://fbref.com/en/squads/d48ad4ff/2022-2023/Napoli-Stats"
2023,"Newcastle Utd","Premier League","team",27,38,607,360,268,254,85,307,642,47.8,335,448,116,332,333,940,680,10,"https://fbref.com/en/squads/b2b47a98/2022-2023/Newcastle-United-Stats"
2023,"Newcastle Utd","Premier League","opponent",27,38,685,421,356,260,69,322,671,48,349,488,167,321,341,1026,854,12,"https://fbref.com/en/squads/b2b47a98/2022-2023/Newcastle-United-Stats"
2023,"Nice","Ligue 1","team",34,38,818,467,415,295,108,382,680,56.2,298,419,115,304,413,1231,588,9,"https://fbref.com/en/squads/132ebc33/2022-2023/Nice-Stats"
2023,"Nice","Ligue 1","opponent",34,38,714,417,327,263,124,330,750,44,420,436,118,318,370,1084,627,13,"https://fbref.com/en/squads/132ebc33/2022-2023/Nice-Stats"
2023,"Nott'ham Forest","Premier League","team",33,38,659,387,380,201,78,296,584,50.7,288,500,156,344,349,1008,944,7,"https://fbref.com/en/squads/e4a775cb/2022-2023/Nottingham-Forest-Stats"
2023,"Nott'ham Forest","Premier League","opponent",33,38,510,301,197,210,103,235,489,48.1,254,355,88,267,286,796,646,16,"https://fbref.com/en/squads/e4a775cb/2022-2023/Nottingham-Forest-Stats"
2023,"Osasuna","La Liga","team",26,38,534,328,256,196,82,266,588,45.2,322,392,97,295,315,849,749,10,"https://fbref.com/en/squads/03c57e2b/2022-2023/Osasuna-Stats"
2023,"Osasuna","La Liga","opponent",26,38,563,332,318,195,50,247,560,44.1,313,381,93,288,311,874,797,7,"https://fbref.com/en/squads/03c57e2b/2022-2023/Osasuna-Stats"
2023,"Paris S-G","Ligue 1","team",26,38,612,362,253,255,104,339,693,48.9,354,378,109,269,296,908,432,20,"https://fbref.com/en/squads/e2d8892c/2022-2023/Paris-Saint-Germain-Stats"
2023,"Paris S-G","Ligue 1","opponent",26,38,815,486,420,280,115,423,877,48.2,454,486,134,352,437,1252,536,8,"https://fbref.com/en/squads/e2d8892c/2022-2023/Paris-Saint-Germain-Stats"
2023,"RB Leipzig","Bundesliga","team",25,34,534,312,237,231,66,253,512,49.4,259,428,94,334,310,844,552,3,"https://fbref.com/en/squads/acbb6a5b/2022-2023/RB-Leipzig-Stats"
2023,"RB Leipzig","Bundesliga","opponent",25,34,586,342,290,234,62,270,615,43.9,345,484,120,364,407,993,586,10,"https://fbref.com/en/squads/acbb6a5b/2022-2023/RB-Leipzig-Stats"
2023,"Rayo Vallecano","La Liga","team",28,38,636,393,262,276,98,281,664,42.3,383,428,92,336,309,945,680,11,"https://fbref.com/en/squads/98e8af82/2022-2023/Rayo-Vallecano-Stats"
2023,"Rayo Vallecano","La Liga","opponent",28,38,664,391,317,278,69,290,586,49.5,296,416,133,283,345,1009,810,10,"https://fbref.com/en/squads/98e8af82/2022-2023/Rayo-Vallecano-Stats"
2023,"Real Madrid","La Liga","team",26,38,542,353,242,212,88,259,565,45.8,306,365,105,260,296,838,469,5,"https://fbref.com/en/squads/53a2f082/2022-2023/Real-Madrid-Stats"
2023,"Real Madrid","La Liga","opponent",26,38,676,408,377,218,81,379,854,44.4,475,492,175,317,331,1007,678,8,"https://fbref.com/en/squads/53a2f082/2022-2023/Real-Madrid-Stats"
2023,"Real Sociedad","La Liga","team",30,38,660,395,304,254,102,285,613,46.5,328,399,103,296,271,931,624,13,"https://fbref.com/en/squads/e31d1cd9/2022-2023/Real-Sociedad-Stats"
2023,"Real Sociedad","La Liga","opponent",30,38,661,403,341,237,83,293,600,48.8,307,402,110,292,325,986,613,15,"https://fbref.com/en/squads/e31d1cd9/2022-2023/Real-Sociedad-Stats"
2023,"Reims","Ligue 1","team",34,38,703,407,338,259,106,339,747,45.4,408,468,127,341,397,1100,633,15,"https://fbref.com/en/squads/7fdd64e0/2022-2023/Reims-Stats"
2023,"Reims","Ligue 1","opponent",34,38,749,440,358,290,101,370,717,51.6,347,430,124,306,482,1231,683,12,"https://fbref.com/en/squads/7fdd64e0/2022-2023/Reims-Stats"
2023,"Rennes","Ligue 1","team",32,38,600,335,255,251,94,289,616,46.9,327,392,91,301,341,941,587,10,"https://fbref.com/en/squads/b3072e00/2022-2023/Rennes-Stats"
2023,"Rennes","Ligue 1","opponent",32,38,645,376,357,239,49,308,718,42.9,410,454,140,314,406,1051,587,11,"https://fbref.com/en/squads/b3072e00/2022-2023/Rennes-Stats"
2023,"Roma","Serie A","team",30,38,624,340,301,257,66,289,617,46.8,328,392,113,279,368,992,590,9,"https://fbref.com/en/squads/cf74a709/2022-2023/Roma-Stats"
2023,"Roma","Serie A","opponent",30,38,633,388,303,253,77,315,589,53.5,274,399,138,261,290,923,621,11,"https://fbref.com/en/squads/cf74a709/2022-2023/Roma-Stats"
2023,"Salernitana","Serie A","team",30,38,587,337,309,220,58,259,569,45.5,310,409,157,252,329,916,740,13,"https://fbref.com/en/squads/c5577084/2022-2023/Salernitana-Stats"
2023,"Salernitana","Serie A","opponent",30,38,564,331,225,257,82,261,525,49.7,264,372,96,276,299,863,564,8,"https://fbref.com/en/squads/c5577084/2022-2023/Salernitana-Stats"
2023,"Sampdoria","Serie A","team",40,38,589,351,290,240,59,261,558,46.8,297,428,152,276,317,906,688,7,"https://fbref.com/en/squads/8ff9e3b3/2022-2023/Sampdoria-Stats"
2023,"Sampdoria","Serie A","opponent",40,38,557,354,244,234,79,222,482,46.1,260,431,99,332,317,874,649,5,"https://fbref.com/en/squads/8ff9e3b3/2022-2023/Sampdoria-Stats"
2023,"Sassuolo","Serie A","team",31,38,502,281,237,186,79,216,461,46.9,245,371,122,249,278,780,658,16,"https://fbref.com/en/squads/e2befd26/2022-2023/Sassuolo-Stats"
2023,"Sassuolo","Serie A","opponent",31,38,634,360,319,244,71,270,569,47.5,299,426,124,302,306,940,625,10,"https://fbref.com/en/squads/e2befd26/2022-2023/Sassuolo-Stats"
2023,"Schalke 04","Bundesliga","team",35,34,542,329,240,246,56,253,551,45.9,298,397,110,287,306,848,723,12,"https://fbref.com/en/squads/c539e393/2022-2023/Schalke-04-Stats"
2023,"Schalke 04","Bundesliga","opponent",35,34,523,316,222,241,60,249,447,55.7,198,394,108,286,262,785,840,2,"https://fbref.com/en/squads/c539e393/2022-2023/Schalke-04-Stats"
2023,"Sevilla","La Liga","team",35,38,587,367,261,230,96,281,591,47.5,310,361,127,234,339,926,633,9,"https://fbref.com/en/squads/ad2be733/2022-2023/Sevilla-Stats"
2023,"Sevilla","La Liga","opponent",35,38,569,353,273,206,90,257,526,48.9,269,358,96,262,271,840,769,13,"https://fbref.com/en/squads/ad2be733/2022-2023/Sevilla-Stats"
2023,"Southampton","Premier League","team",36,38,713,426,377,279,57,297,611,48.6,314,542,165,377,428,1141,852,11,"https://fbref.com/en/squads/33c895d4/2022-2023/Southampton-Stats"
2023,"Southampton","Premier League","opponent",36,38,718,418,311,306,101,318,679,46.8,361,445,114,331,318,1036,718,9,"https://fbref.com/en/squads/33c895d4/2022-2023/Southampton-Stats"
2023,"Spezia","Serie A","team",34,38,622,359,290,236,96,254,569,44.6,315,457,161,296,301,923,830,7,"https://fbref.com/en/squads/68449f6d/2022-2023/Spezia-Stats"
2023,"Spezia","Serie A","opponent",34,38,669,367,314,257,98,303,581,52.2,278,430,117,313,354,1023,749,6,"https://fbref.com/en/squads/68449f6d/2022-2023/Spezia-Stats"
2023,"Strasbourg","Ligue 1","team",29,38,690,409,316,284,90,344,666,51.7,322,423,98,325,437,1127,688,5,"https://fbref.com/en/squads/c0d3eab4/2022-2023/Strasbourg-Stats"
2023,"Strasbourg","Ligue 1","opponent",29,38,590,341,259,254,77,277,617,44.9,340,391,104,287,344,934,702,11,"https://fbref.com/en/squads/c0d3eab4/2022-2023/Strasbourg-Stats"
2023,"Stuttgart","Bundesliga","team",30,34,528,316,255,207,66,268,524,51.1,256,421,113,308,308,836,666,10,"https://fbref.com/en/squads/598bc722/2022-2023/Stuttgart-Stats"
2023,"Stuttgart","Bundesliga","opponent",30,34,655,378,305,274,76,319,656,48.6,337,404,123,281,292,947,653,11,"https://fbref.com/en/squads/598bc722/2022-2023/Stuttgart-Stats"
2023,"Torino","Serie A","team",28,38,473,265,231,187,55,199,367,54.2,168,337,110,227,292,765,627,9,"https://fbref.com/en/squads/105360fe/2022-2023/Torino-Stats"
2023,"Torino","Serie A","opponent",28,38,590,312,309,234,47,276,579,47.7,303,407,122,285,306,896,626,5,"https://fbref.com/en/squads/105360fe/2022-2023/Torino-Stats"
2023,"Tottenham","Premier League","team",29,38,619,353,325,215,79,275,574,47.9,299,428,148,280,340,959,762,20,"https://fbref.com/en/squads/361ca564/2022-2023/Tottenham-Hotspur-Stats"
2023,"Tottenham","Premier League","opponent",29,38,644,393,290,244,110,288,594,48.5,306,502,150,352,322,966,717,12,"https://fbref.com/en/squads/361ca564/2022-2023/Tottenham-Hotspur-Stats"
2023,"Toulouse","Ligue 1","team",29,38,716,406,349,264,103,368,842,43.7,474,476,138,338,409,1125,656,15,"https://fbref.com/en/squads/3f8c4b5f/2022-2023/Toulouse-Stats"
2023,"Toulouse","Ligue 1","opponent",29,38,605,342,291,230,84,302,585,51.6,283,490,106,384,399,1004,600,16,"https://fbref.com/en/squads/3f8c4b5f/2022-2023/Toulouse-Stats"
2023,"Troyes","Ligue 1","team",32,38,608,361,333,207,68,272,606,44.9,334,416,144,272,398,1006,779,5,"https://fbref.com/en/squads/54195385/2022-2023/Troyes-Stats"
2023,"Troyes","Ligue 1","opponent",32,38,688,388,260,290,138,347,712,48.7,365,399,97,302,383,1071,498,8,"https://fbref.com/en/squads/54195385/2022-2023/Troyes-Stats"
2023,"Udinese","Serie A","team",30,38,651,365,363,228,60,326,632,51.6,306,437,128,309,314,965,712,8,"https://fbref.com/en/squads/04eea015/2022-2023/Udinese-Stats"
2023,"Udinese","Serie A","opponent",30,38,686,389,341,251,94,350,680,51.5,330,438,146,292,301,987,593,11,"https://fbref.com/en/squads/04eea015/2022-2023/Udinese-Stats"
2023,"Union Berlin","Bundesliga","team",28,34,494,278,217,216,61,239,525,45.5,286,356,101,255,262,756,704,6,"https://fbref.com/en/squads/7a41008f/2022-2023/Union-Berlin-Stats"
2023,"Union Berlin","Bundesliga","opponent",28,34,424,254,251,123,50,180,362,49.7,182,359,82,277,234,658,760,11,"https://fbref.com/en/squads/7a41008f/2022-2023/Union-Berlin-Stats"
2023,"Valencia","La Liga","team",28,38,678,430,340,254,84,311,645,48.2,334,370,75,295,288,966,643,21,"https://fbref.com/en/squads/dcc91a7b/2022-2023/Valencia-Stats"
2023,"Valencia","La Liga","opponent",28,38,645,382,354,219,72,307,658,46.7,351,418,133,285,294,939,834,15,"https://fbref.com/en/squads/dcc91a7b/2022-2023/Valencia-Stats"
2023,"Valladolid","La Liga","team",36,38,671,396,334,251,86,296,628,47.1,332,432,149,283,345,1016,767,8,"https://fbref.com/en/squads/17859612/2022-2023/Valladolid-Stats"
2023,"Valladolid","La Liga","opponent",36,38,634,389,309,232,93,318,627,50.7,309,409,97,312,264,898,662,5,"https://fbref.com/en/squads/17859612/2022-2023/Valladolid-Stats"
2023,"Villarreal","La Liga","team",32,38,578,370,276,201,101,270,534,50.6,264,372,125,247,262,840,691,16,"https://fbref.com/en/squads/2a8183b3/2022-2023/Villarreal-Stats"
2023,"Villarreal","La Liga","opponent",32,38,688,423,349,240,99,345,780,44.2,435,426,114,312,349,1037,618,16,"https://fbref.com/en/squads/2a8183b3/2022-2023/Villarreal-Stats"
2023,"Werder Bremen","Bundesliga","team",25,34,595,349,269,273,53,300,617,48.6,317,371,103,268,321,916,789,7,"https://fbref.com/en/squads/62add3bf/2022-2023/Werder-Bremen-Stats"
2023,"Werder Bremen","Bundesliga","opponent",25,34,474,290,182,224,68,228,461,49.5,233,371,80,291,304,778,568,5,"https://fbref.com/en/squads/62add3bf/2022-2023/Werder-Bremen-Stats"
2023,"West Ham","Premier League","team",25,38,608,336,290,226,92,270,562,48,292,415,139,276,408,1016,810,10,"https://fbref.com/en/squads/7c21e445/2022-2023/West-Ham-United-Stats"
2023,"West Ham","Premier League","opponent",25,38,623,373,286,249,88,266,515,51.7,249,453,142,311,292,915,816,13,"https://fbref.com/en/squads/7c21e445/2022-2023/West-Ham-United-Stats"
2023,"Wolfsburg","Bundesliga","team",28,34,543,324,255,206,82,265,521,50.9,256,443,116,327,292,835,701,9,"https://fbref.com/en/squads/4eaa11d7/2022-2023/Wolfsburg-Stats"
2023,"Wolfsburg","Bundesliga","opponent",28,34,540,321,249,218,73,268,524,51.1,256,378,97,281,307,847,573,9,"https://fbref.com/en/squads/4eaa11d7/2022-2023/Wolfsburg-Stats"
2023,"Wolves","Premier League","team",32,38,661,370,364,222,75,286,609,47,323,497,175,322,279,940,817,19,"https://fbref.com/en/squads/8cec06e1/2022-2023/Wolverhampton-Wanderers-Stats"
2023,"Wolves","Premier League","opponent",32,38,629,360,281,225,123,302,677,44.6,375,424,114,310,317,946,712,13,"https://fbref.com/en/squads/8cec06e1/2022-2023/Wolverhampton-Wanderers-Stats"
